Cell	Cluster
CTCGAGGTCTGGGCCA-1	T cells
CACAGGCTCACGGTTA-1	T cells
CCGGGATTCCTCAACC-1	T cells
AGAGCTTGTCGCTTCT-1	NK cells
GCATACAGTCAGATAA-1	B cells
TCGAGGCGTTCGCGAC-1	T cells
AGAGCGACACAGACTT-1	NK cells
AGGCCGTGTCTTGCGG-1	T cells
TTTACTGCAAACCCAT-1	T cells
AACCGCGAGGGTGTGT-1	Monocytes
CACCAGGGTGACAAAT-1	T cells
TGATTTCAGCTAGTCT-1	Monocytes
TGACGGCTCGGTTAAC-1	Monocytes
AAGACCTTCACCGGGT-1	T cells
CTCCTAGGTGGCTCCA-1	T cells
GCGGGTTGTGGGTATG-1	B cells
GATCGATCAAGTTAAG-1	T cells
GTAACGTTCCTGCAGG-1	NK cells
CCGGTAGCAATGGACG-1	B cells
CGGTTAACAACGATCT-1	T cells
CGTTGGGCAGGTTTCA-1	T cells
GTCCTCATCCCATTAT-1	T cells
ATAACGCTCTACGAGT-1	T cells
TCGTAGACATTCCTGC-1	NK cells
GTGAAGGAGAGTAATC-1	B cells
TCTTTCCTCCGTAGTA-1	NK cells
GACAGAGGTCTAGAGG-1	T cells
ATAGACCGTGTGACGA-1	Monocytes
ACGGAGAGTCGAGTTT-1	Monocytes
TGGGCGTCATTGCGGC-1	T cells
ATCGAGTTCATTTGGG-1	T cells
GACTAACCAATGACCT-1	T cells
CCTAGCTCAAACTGCT-1	T cells
CATCAAGTCACGACTA-1	Doublets
GGGTTGCTCAATCTCT-1	T cells
GCATGATGTCTCAACA-1	T cells
CTCCTAGAGAACAATC-1	T cells
CGACTTCCAAACGCGA-1	NK cells
TACGGTAGTCGAATCT-1	T cells
CCTAGCTAGTACGACG-1	T cells
CGTTCTGCAAGCGTAG-1	T cells
ACCCACTGTAGGCTGA-1	T cells
TTGACTTTCATCTGCC-1	T cells
ACACCAAAGTTCCACA-1	T cells
GTTACAGGTCGTGGCT-1	T cells
CGTGAGCGTAGGGACT-1	T cells
GAATGAATCTTTAGTC-1	T cells
CCTATTAAGTCTCGGC-1	B cells
GCACTCTAGCGTAGTG-1	T cells
TAAGCGTAGCTGAAAT-1	T cells
ATCTGCCCACCAGTTA-1	T cells
ATGAGGGCATGCAACT-1	T cells
AAAGTAGTCAAACCAC-1	Monocytes
CTGGTCTAGTAGGCCA-1	T cells
ACTTGTTTCGGCTACG-1	T cells
TGCACCTAGGCTAGGT-1	Monocytes
CTTCTCTTCTACGAGT-1	T cells
TTAACTCGTGGTGTAG-1	T cells
ACTGTCCGTATGGTTC-1	Monocytes
ACTGTCCAGTGGGATC-1	T cells
CATCGGGTCATCTGTT-1	T cells
GATCAGTCACAAGTAA-1	T cells
CGAGAAGGTAGAGGAA-1	T cells
GGGCATCTCTCTTATG-1	Monocytes
CATGACAGTCCATGAT-1	mDCs
TGCGCAGTCGAGCCCA-1	Monocytes
GATCGCGGTCACCTAA-1	T cells
GGGTTGCTCTCTGCTG-1	B cells
TGCCAAAAGATGTAAC-1	T cells
AGCCTAAGTAGCGCAA-1	T cells
CACACAAGTTCAGCGC-1	T cells
CAGGTGCGTGGTACAG-1	T cells
GGGTCTGGTAGAGGAA-1	Monocytes
GACCTGGCAATTCCTT-1	Monocytes
CCAATCCCAAGCCGTC-1	Monocytes
AAGGCAGAGAATCTCC-1	B cells
CCTTCGATCAGGCGAA-1	NK cells
CTCTGGTGTGAACCTT-1	Monocytes
ACACCAAAGACTGGGT-1	T cells
AATCCAGAGTAATCCC-1	NK cells
CATATTCCAGGTTTCA-1	B cells
TAAGTGCCACTGCCAG-1	Monocytes
TAAGCGTCATCGATTG-1	T cells
GGCAATTGTGATGTGG-1	Monocytes
CCGGGATAGCCAGGAT-1	T cells
CATCAGAAGACAATAC-1	T cells
CTCTAATGTCGAATCT-1	T cells
TTTGGTTTCGCTAGCG-1	Monocytes
CATTATCAGCTGAAAT-1	T cells
CACAGTAGTTCGTCTC-1	T cells
GACAGAGCAATAGAGT-1	T cells
CGTCACTAGTGTCTCA-1	T cells
GGCTCGAAGTTGCAGG-1	T cells
CATATTCTCTCTTGAT-1	B cells
GGAGCAATCATTGCGA-1	B cells
CACACCTCAGACGTAG-1	B cells
AGAATAGCAGTGGGAT-1	Monocytes
AACTGGTTCCTTCAAT-1	NK cells
GGCGACTAGTGTACTC-1	T cells
GTATCTTGTTCGCTAA-1	T cells
TGGACGCTCTAGAGTC-1	Monocytes
GTGGGTCGTCCGAAGA-1	Monocytes
TACGGATTCGCGGATC-1	T cells
GTGGGTCTCTGATTCT-1	T cells
CGCGGTACAGACAAGC-1	Doublets
ACACCAACAACTGCTA-1	T cells
TACGGTAAGGCGACAT-1	T cells
CCACTACAGACGACGT-1	T cells
AAGGCAGTCCGCGGTA-1	T cells
ACGGGCTTCCACGTGG-1	Monocytes
GTGGGTCAGACTAAGT-1	T cells
AAAGTAGCAGCTGTTA-1	B cells
TACTCATGTTCGCTAA-1	Monocytes
CATATTCTCTTGCATT-1	T cells
ACACCCTAGTACGTTC-1	B cells
AACGTTGTCACTGGGC-1	mDCs
TCGTAGATCACATAGC-1	T cells
CAGAGAGAGAGTTGGC-1	T cells
GTTCGGGCAGATCTGT-1	NK cells
CTGCTGTGTTACGTCA-1	B cells
TGAGAGGAGATATACG-1	B cells
TGCGTGGTCTTGAGGT-1	T cells
TAGTTGGGTCGAAAGC-1	Monocytes
CTCGAGGAGTTATCGC-1	B cells
TTAACTCAGCTGTCTA-1	NK cells
GCTGCGATCAACACGT-1	T cells
CCAGCGAAGTCAAGCG-1	T cells
AGTAGTCTCCGGCACA-1	Monocytes
AGATTGCCATCGTCGG-1	B cells
GCACTCTTCATGTCTT-1	T cells
CTGCCTAGTCGACTGC-1	T cells
ATAGACCCAAAGAATC-1	B cells
GCATGCGCATCGATTG-1	T cells
TGGTTAGAGCTGCCCA-1	T cells
TGTGGTAAGGTGCTAG-1	T cells
ATCATCTCAGTAAGCG-1	B cells
CATATTCTCGGAGGTA-1	T cells
TGCCCTAGTCGCGTGT-1	T cells
TCAGCAACACTAGTAC-1	T cells
GTAGTCACAGACAGGT-1	B cells
CGCGGTAGTGATAAGT-1	Monocytes
CGATGTATCGGCGCTA-1	Monocytes
AGACGTTTCTGGTATG-1	T cells
GGACAAGTCAGTTCGA-1	B cells
ACTTACTCAGTACACT-1	T cells
AGTAGTCCATGGTTGT-1	Monocytes
CCAATCCCAAACCTAC-1	T cells
ACCCACTTCGGCTTGG-1	T cells
TGGCCAGGTGGTACAG-1	T cells
TCTGAGATCAACACAC-1	T cells
TGAAAGATCATGTAGC-1	T cells
GCTGGGTCACTTAAGC-1	pDCs
TATCAGGTCTGTGCAA-1	T cells
GCTGCGATCGTTGCCT-1	NK cells
GAAACTCAGCCATCGC-1	Monocytes
CTTACCGCAATGGACG-1	T cells
AGCTCTCTCCAGAGGA-1	T cells
AAGGAGCGTAGTACCT-1	T cells
CATATGGAGTAGCCGA-1	Monocytes
TTATGCTAGAGATGAG-1	mDCs
CTCGGGAGTTTAGGAA-1	T cells
AACACGTCACCTGGTG-1	pDCs
CTAACTTGTACCCAAT-1	T cells
GCTGCGAAGCTGTTCA-1	T cells
ATTGGACTCGAATGCT-1	T cells
CTGCTGTAGACTAAGT-1	T cells
CACATTTCAACACCTA-1	Monocytes
AGGCCACGTTTACTCT-1	Monocytes
ACTTACTCATTTGCTT-1	B cells
CGATGTACACTTCTGC-1	T cells
ACTTACTAGTCCCACG-1	T cells
AGGTCATCACACCGAC-1	T cells
ATTGGTGTCGTTGACA-1	Monocytes
GCTGGGTGTCAGCTAT-1	T cells
GACTACATCAGTGCAT-1	Monocytes
GGAATAACACAAGACG-1	T cells
CGAATGTAGTACGATA-1	T cells
GTAGTCATCAGCTCTC-1	Monocytes
TGGGAAGCATATACCG-1	T cells
GATGCTACATTTCACT-1	Monocytes
TGCGGGTAGTGGGCTA-1	T cells
GCGCAACTCGTTTGCC-1	T cells
CGACTTCCAATGCCAT-1	B cells
TGACTAGAGTTAGCGG-1	T cells
TGCTACCGTAGCGCAA-1	T cells
CACCAGGTCTTCGAGA-1	T cells
AGTGGGAGTCAGAAGC-1	B cells
GTAGGCCGTTGTCTTT-1	Monocytes
CATGGCGGTTCAGGCC-1	T cells
AGGCCGTAGACTACAA-1	T cells
GTTCTCGGTCTCACCT-1	T cells
CGACCTTCATTGGGCC-1	T cells
CTCTACGAGCCAGAAC-1	T cells
ATCATCTAGCTCCTCT-1	T cells
GACAGAGAGGGTGTGT-1	mDCs
CCCTCCTCAAGTCATC-1	Monocytes
CCGGTAGGTCTCTCGT-1	Monocytes
TGGGCGTTCTCCGGTT-1	Monocytes
CTAACTTGTAAGGGCT-1	T cells
GTCGTAAAGGTGTTAA-1	NK cells
CCCTCCTTCGAATGGG-1	T cells
AAGTCTGAGTCAAGCG-1	B cells
GTCACGGCATGTAAGA-1	T cells
TGAGCATGTCAGAATA-1	T cells
TAAGAGAGTGCTAGCC-1	T cells
TACCTATCATTGGGCC-1	T cells
GTAACTGTCATGTCCC-1	B cells
TTCGGTCGTGCATCTA-1	Monocytes
ATTACTCCACAAGTAA-1	T cells
TACTTACAGAAACCTA-1	Monocytes
CTAAGACTCTGTTGAG-1	T cells
TACACGACAAGCCTAT-1	T cells
CCTAGCTGTCGCGTGT-1	mDCs
TATCTCAAGCTTCGCG-1	T cells
GCGAGAATCACAGGCC-1	T cells
CTCTACGGTTAAGATG-1	Monocytes
TCACGAAAGTATCTCG-1	T cells
TAAGTGCGTCCGTCAG-1	B cells
CTCGAAAAGCGCCTTG-1	T cells
CGTTAGACAACGATCT-1	Monocytes
CTGTGCTCATGCAACT-1	Monocytes
GCGACCAGTAATCACC-1	T cells
GCTGCTTGTTAAGGGC-1	NK cells
CCTTTCTCACTCGACG-1	T cells
TGCGGGTGTCAGAATA-1	T cells
CAGATCAAGCAATCTC-1	T cells
CTGATCCGTTCGCGAC-1	T cells
GATCAGTAGCTCTCGG-1	T cells
CCGTACTAGGGATCTG-1	T cells
GCTGCTTAGAGGTAGA-1	B cells
GAGCAGATCGGGAGTA-1	T cells
TGAGGGACACCATGTA-1	B cells
ACTGATGCAGTCCTTC-1	Monocytes
AGAATAGAGACCTTTG-1	T cells
TCTCATATCTGCGTAA-1	T cells
CCCTCCTGTAGGGTAC-1	B cells
CCCATACTCTTTCCTC-1	Monocytes
CTGATAGCAACTGGCC-1	T cells
TGTTCCGCAGTAAGAT-1	B cells
CAGCAGCAGAGTAAGG-1	T cells
TCTCTAACATCTCGCT-1	T cells
AACTCCCCATTAGCCA-1	T cells
CAGGTGCAGATCACGG-1	T cells
TCTCTAATCAACGGGA-1	B cells
GTCACAAGTTGCCTCT-1	Monocytes
GTAACTGGTTCACGGC-1	mDCs
TACCTATCACCAACCG-1	T cells
CAGGTGCGTATTACCG-1	Monocytes
TTTACTGCAGTTAACC-1	T cells
ACTGAGTGTGACCAAG-1	Monocytes
GAAACTCTCAGGCAAG-1	T cells
TATTACCGTCGCGTGT-1	B cells
GAATAAGAGGCATTGG-1	T cells
CTAACTTCATCTGGTA-1	T cells
ATGGGAGAGAGTCGGT-1	Doublets
CACCAGGTCGAGGTAG-1	T cells
ATGGGAGTCGACAGCC-1	T cells
AGCTTGAAGCCCAACC-1	NK cells
ACACCAAAGGCTATCT-1	T cells
GCTCTGTAGTTTCCTT-1	Doublets
GGATTACAGAGTAAGG-1	T cells
GTGTTAGCATCACCCT-1	B cells
AGCGTCGGTTTCCACC-1	Monocytes
CTTGGCTTCCACGAAT-1	B cells
GGAGCAAAGAAACGCC-1	T cells
CCAATCCTCGAATCCA-1	T cells
GTAGGCCGTACGCTGC-1	Monocytes
AGGGAGTCACGGTGTC-1	B cells
TCATTTGGTGGGTCAA-1	T cells
GCTTGAACAAATCCGT-1	NK cells
CGCGTTTTCTGCTTGC-1	Monocytes
GATCGCGGTGGCGAAT-1	T cells
TTTATGCAGGATATAC-1	T cells
GTTAAGCCAATCCGAT-1	T cells
TCTGAGAAGGCCCTTG-1	T cells
GTAGTCAAGGGTCTCC-1	B cells
TTTGGTTCACTTAAGC-1	Monocytes
ACTGCTCTCTTGTCAT-1	T cells
TCTTCGGTCGGAGCAA-1	T cells
GATGAGGTCCGAATGT-1	T cells
CGACCTTCATTCTTAC-1	T cells
CTCACACAGCCCGAAA-1	Monocytes
GTATTCTGTAGTGAAT-1	mDCs
ACGGGTCGTGGTCCGT-1	Monocytes
CAGCAGCAGAAGAAGC-1	B cells
GCTCTGTGTTAAGAAC-1	T cells
AAAGCAATCGTATCAG-1	NK cells
GATCGCGTCAGCTTAG-1	T cells
CTGAAACGTCATACTG-1	T cells
GGACATTTCGAACGGA-1	B cells
ACCCACTCATAAGACA-1	B cells
CTCGTCAAGTAATCCC-1	Monocytes
CATGGCGGTGGCTCCA-1	T cells
GCAAACTGTGTTGGGA-1	B cells
TGACTAGAGTTGCAGG-1	Doublets
CGGGTCATCGCCTGTT-1	Monocytes
TAAACCGTCACTGGGC-1	Monocytes
AGAGCTTGTCAGAGGT-1	T cells
ATAACGCTCCTGTAGA-1	Monocytes
TCGCGAGGTGCTTCTC-1	T cells
TTCGGTCAGTGTACTC-1	T cells
GCATACATCTTTAGGG-1	Monocytes
AGAATAGTCTGGCGAC-1	B cells
TGCTACCGTACACCGC-1	Monocytes
CGCGGTAAGCCAGTTT-1	B cells
TCAGGATAGAGTCTGG-1	T cells
GACGTTAGTCCTCCAT-1	T cells
TTCTACAGTCTCATCC-1	T cells
TATCAGGAGTTTCCTT-1	T cells
GTCACAAAGGCAATTA-1	B cells
ACGATACCAGATGAGC-1	Monocytes
TTAGTTCGTACACCGC-1	T cells
GCATACAGTCTAGCCG-1	Monocytes
CGCGGTACAGGTCCAC-1	B cells
ACTGATGTCGGTCTAA-1	T cells
GGAGCAAAGACACGAC-1	Monocytes
CAGAATCGTAATTGGA-1	T cells
TCAGATGTCGCAAACT-1	Monocytes
CGCGGTATCTTGAGGT-1	Monocytes
CTCTACGCACACCGAC-1	B cells
ACAGCCGGTCTTGATG-1	Monocytes
GGACAAGGTCTTGATG-1	Monocytes
TGCCCTATCTTGCAAG-1	T cells
TTCTCCTTCCGAATGT-1	T cells
CTCGTACCACCTCGGA-1	T cells
CAAGATCCACATAACC-1	T cells
GCGCCAATCAAACCAC-1	Monocytes
TGTCCCAAGAAGGTGA-1	T cells
AGTAGTCAGTCCGTAT-1	T cells
CAACCTCTCAACACGT-1	NK cells
TTCTACATCGCCTGTT-1	NK cells
AGCAGCCCAGATAATG-1	T cells
GGTGAAGGTACCTACA-1	T cells
AATCCAGAGAGACTAT-1	NK cells
GTCATTTAGAGACGAA-1	T cells
CTAGAGTAGACCCACC-1	Monocytes
AGCTCTCAGGCTCATT-1	B cells
AGCTCTCAGCACCGCT-1	Monocytes
TTGCGTCCAAGCTGGA-1	T cells
AGAGCTTGTCTGATTG-1	T cells
TGAGAGGCAGCGTAAG-1	T cells
CGGGTCAGTGTGACGA-1	T cells
TCGAGGCGTTAAGACA-1	T cells
TCACGAATCAAGATCC-1	T cells
AGATCTGAGAGATGAG-1	Monocytes
CGACCTTTCGGAAATA-1	Monocytes
TATGCCCAGAGCTATA-1	T cells
GTGCATAAGAACTCGG-1	B cells
CAGCGACAGCTAGGCA-1	T cells
CGACTTCTCGTCCAGG-1	Monocytes
GTGAAGGAGTGCAAGC-1	Monocytes
TACAGTGGTAAGTAGT-1	B cells
GACGGCTCAGTTTACG-1	T cells
GCGACCAGTGCAGACA-1	Monocytes
AACCGCGAGACACTAA-1	T cells
GTCATTTCATGATCCA-1	T cells
TCAACGAAGTTAACGA-1	T cells
GCTTGAAGTAGCTGCC-1	B cells
GATGAAACACAGAGGT-1	T cells
CGTCACTAGACTCGGA-1	T cells
CATGGCGAGAGATGAG-1	B cells
TTCTTAGAGGCTCAGA-1	T cells
GAGCAGAGTCTACCTC-1	T cells
TACTTGTAGGGAACGG-1	mDCs
CTCATTACATGAACCT-1	T cells
CCTACACAGTGCAAGC-1	T cells
AGAATAGCATTATCTC-1	Monocytes
TACTCATTCGTACCGG-1	Monocytes
GTGCAGCCAGGCAGTA-1	T cells
GTCTCGTTCGCAGGCT-1	B cells
ATTATCCGTAAATGAC-1	T cells
AACGTTGTCCACGAAT-1	Doublets
GTAACTGAGAGATGAG-1	T cells
ACCAGTAGTTGTACAC-1	B cells
GTGAAGGAGCTACCGC-1	T cells
AAGCCGCGTAGCAAAT-1	T cells
AAAGCAAGTCTTTCAT-1	T cells
CGATGTATCGGACAAG-1	T cells
TCACGAATCGTCTGAA-1	T cells
AGCGTCGAGTGAAGTT-1	T cells
GTGCTTCAGACTTGAA-1	B cells
GCGCCAACAGCTTAAC-1	T cells
TTGGCAAGTACTCGCG-1	Monocytes
TTCTCAAGTCTAGCGC-1	Monocytes
CGCCAAGTCCCTGACT-1	T cells
ACGGAGAGTCACAAGG-1	T cells
TTCTTAGTCCCAAGAT-1	Monocytes
CAACTAGAGAAACCAT-1	Doublets
AGTGAGGGTGTCTGAT-1	NK cells
GACCAATCAAGACACG-1	T cells
CTGTGCTTCCATTCTA-1	T cells
TCTATTGAGACAGGCT-1	B cells
CGATTGAAGTACTTGC-1	Doublets
GCGCAACGTTAGGGTG-1	Monocytes
GGGCACTTCACTCTTA-1	T cells
TCAACGACATTCACTT-1	Monocytes
ACGGCCAAGAGATGAG-1	T cells
TACGGGCGTCAGAATA-1	T cells
GAATAAGTCGCCAGCA-1	B cells
GACACGCGTGCAGTAG-1	T cells
TATTACCGTACCAGTT-1	B cells
AGGCCACGTAGAGCTG-1	T cells
TTCCCAGAGAAGGTTT-1	T cells
AAGGTTCTCTTGAGGT-1	T cells
TGGTTAGCAAGCCGCT-1	T cells
AGAGTGGAGAGGGCTT-1	Monocytes
TGCCCATAGTGCAAGC-1	T cells
TGACGGCTCCTGCTTG-1	Monocytes
TCTCATAGTTTGCATG-1	Monocytes
TGGGAAGTCGATAGAA-1	T cells
CGCTATCTCTTAACCT-1	Doublets
GACCAATTCTTCAACT-1	B cells
CACATAGCATGAACCT-1	Monocytes
CGTGTAACACGTGAGA-1	T cells
CATTATCGTCTCTTTA-1	Monocytes
CACACAAAGCAAATCA-1	T cells
CTCGAGGGTAAATGAC-1	T cells
CAAGATCGTAAATGTG-1	Monocytes
CGTTAGAGTTAAAGAC-1	Monocytes
CATTATCGTCTCACCT-1	T cells
CTTACCGCAGTACACT-1	T cells
CATTATCAGCTGCGAA-1	T cells
CGATGGCCAAGACACG-1	T cells
CTCGGGAGTTTGGGCC-1	T cells
GCATACAAGTCGTTTG-1	Monocytes
TTGAACGTCAAGGCTT-1	B cells
ACGATACCAATTCCTT-1	B cells
CTGAAGTCACGGTAGA-1	T cells
TGGTTAGGTTCTGTTT-1	Monocytes
ATCTACTCATGTCTCC-1	Monocytes
GGGCATCAGCACAGGT-1	T cells
GTCACAATCCGGGTGT-1	Monocytes
TGAGCCGCAAGTTGTC-1	Monocytes
TTCTCAAAGCCAGTTT-1	T cells
TCAGCTCCACGACTCG-1	T cells
CTACACCAGCGTAATA-1	T cells
GAACGGATCCTAGAAC-1	T cells
ACGGCCAAGCGATGAC-1	NK cells
CAGCAGCCATGTCTCC-1	mDCs
AGATCTGCAGGACGTA-1	Monocytes
GACGTTAAGGGAAACA-1	Doublets
TGACAACAGAGCTATA-1	Doublets
CATCAGAAGAAACGCC-1	T cells
ATCATGGGTAACGTTC-1	B cells
CGATGGCCAATAACGA-1	T cells
CTGAAGTGTTTGTTGG-1	T cells
CCACTACTCTCTGCTG-1	B cells
GCGGGTTCAATAAGCA-1	Monocytes
GGGTCTGGTGTTTGGT-1	T cells
ACGATACAGCCCAGCT-1	mDCs
ACTTTCATCTGCGACG-1	Monocytes
CTCGAGGTCGGAGGTA-1	T cells
GAACCTACATGGGAAC-1	B cells
GCTGCTTTCGTTGACA-1	Monocytes
GCATGATCAATCCAAC-1	B cells
ACCAGTAGTAGAGCTG-1	Monocytes
AAACCTGAGACAGACC-1	Monocytes
CAGTCCTTCGGCGCAT-1	Monocytes
GAAGCAGTCACGAAGG-1	Monocytes
AACTCTTTCAACGAAA-1	T cells
CCCAATCGTAGCTAAA-1	T cells
GATCAGTAGGGTTTCT-1	T cells
TAAGAGACACGTGAGA-1	T cells
GCGAGAACACAGGAGT-1	T cells
CACACTCCAGACAAGC-1	T cells
GGAATAAAGCTCAACT-1	T cells
TTTCCTCGTTACCGAT-1	Monocytes
CAAGGCCAGCGATAGC-1	T cells
TGAGCATGTAATCGTC-1	T cells
AAGGTTCAGGTGATAT-1	Monocytes
GGTATTGCAACTGGCC-1	B cells
CGATCGGTCGCGTTTC-1	T cells
TTAACTCGTGACTCAT-1	Monocytes
ACACCAATCTTGACGA-1	T cells
CCTAAAGGTGTGAAAT-1	T cells
AGGGATGGTTTGCATG-1	T cells
TTCGGTCCAGGGAGAG-1	Monocytes
TGACGGCCATGCTGGC-1	pDCs
TTTACTGGTGGGTCAA-1	T cells
TATCTCAAGCTGGAAC-1	T cells
TCATTTGCACCTGGTG-1	Doublets
ATCACGATCACCACCT-1	B cells
CCTAGCTCAGACGCCT-1	NK cells
GCACATACAAACAACA-1	T cells
GCGCCAAAGGCTAGAC-1	B cells
CGACCTTTCATCACCC-1	T cells
GTTCATTAGTTAACGA-1	B cells
GAAGCAGCAAGTTAAG-1	T cells
CTTACCGGTATGAAAC-1	T cells
TGGCTGGCACTATCTT-1	B cells
TAGAGCTCATCTACGA-1	B cells
CACATAGGTTTGGGCC-1	Monocytes
AGGTCCGTCGGACAAG-1	Monocytes
TTGCGTCGTGGTCCGT-1	NK cells
TCACAAGGTCCAACTA-1	B cells
GATGAAAGTTGATTCG-1	Monocytes
ACGGGTCGTGCACCAC-1	T cells
CTCACACCATGCCCGA-1	T cells
GCATGCGGTGAGGCTA-1	B cells
CCTAAAGTCAAAGACA-1	Monocytes
TGGCGCAGTGGCAAAC-1	T cells
CTCTGGTCATAACCTG-1	B cells
CTCTAATGTTTGGGCC-1	T cells
GGCCGATAGTCGTTTG-1	Monocytes
CACATTTTCCAAACAC-1	B cells
TGCCCATAGGGAACGG-1	T cells
GACGCGTGTATGGTTC-1	T cells
CCACGGAGTTTGGCGC-1	T cells
GATGAGGTCGTACCGG-1	T cells
GCATACAAGCAATCTC-1	T cells
GACTAACGTACCGGCT-1	Monocytes
CGCGTTTGTAGATTAG-1	T cells
ACTATCTGTTAAGAAC-1	T cells
TTGACTTGTAGCGTAG-1	T cells
CAAGTTGAGATCCTGT-1	mDCs
TAAGAGAAGCCGATTT-1	T cells
CCTTACGTCTTACCTA-1	T cells
CCGTACTTCACAGTAC-1	T cells
TACTCGCGTCGAGTTT-1	T cells
CGTTAGACAGATAATG-1	Monocytes
CACCTTGGTGGTCCGT-1	Doublets
GCGCGATTCGGTGTTA-1	T cells
GATTCAGAGGCAATTA-1	T cells
TCGCGTTGTACGAAAT-1	T cells
ATCTACTGTTGGTAAA-1	T cells
CTTGGCTTCGGAGGTA-1	NK cells
CACAGGCCACGAAAGC-1	B cells
CATGGCGAGCTGCCCA-1	NK cells
ATCGAGTTCCGCATAA-1	Doublets
GACCAATTCCCTTGTG-1	Monocytes
CGGACACTCTGCTTGC-1	T cells
GTACTCCGTGTGCGTC-1	T cells
ACGATACGTTAAGAAC-1	T cells
CTCGGGATCTTTACGT-1	B cells
GGGATGAAGAGGGATA-1	mDCs
ACGAGCCAGTCGATAA-1	T cells
CGATTGACAGCATGAG-1	Monocytes
AACGTTGGTGTAACGG-1	T cells
CAAGAAATCCGCTGTT-1	T cells
ACACTGATCTTTAGGG-1	T cells
TACCTTAAGTGTGAAT-1	mDCs
CATCCACGTAAGGGAA-1	Monocytes
ACCGTAAAGATAGGAG-1	Monocytes
ACAGCCGTCACCGTAA-1	T cells
GGGTTGCCACGGATAG-1	T cells
ACTTTCACACATGTGT-1	T cells
TGCCAAACATCCCACT-1	T cells
CGTTGGGCAGTCTTCC-1	T cells
ACTTACTGTTGCGTTA-1	T cells
GACTAACCAATTCCTT-1	T cells
CTCATTAAGCCAACAG-1	T cells
TTGGCAACATTAGGCT-1	B cells
CCTATTATCTTACCGC-1	T cells
GACTGCGGTCTAGTGT-1	B cells
GCGCAACAGCGATCCC-1	T cells
CTCGTACCATGAGCGA-1	T cells
GTACTCCCAACTTGAC-1	mDCs
TACGGATGTAGGGTAC-1	T cells
TCGCGTTTCTGAAAGA-1	Doublets
ATAACGCGTCAGATAA-1	Doublets
CGGCTAGGTTTCCACC-1	Monocytes
ATTATCCTCGGATGTT-1	T cells
GTCCTCAGTTGAGTTC-1	T cells
AATCCAGGTGCGCTTG-1	Monocytes
CACCTTGTCTCCTATA-1	B cells
AGCTCCTTCTGCGGCA-1	T cells
ACCCACTAGCGCCTCA-1	NK cells
CATCGGGTCCCGACTT-1	B cells
CACACTCAGAAGAAGC-1	T cells
GAATGAAGTCTCGTTC-1	T cells
CTGCGGAAGTTCGCGC-1	B cells
ACACCAAGTAGCGATG-1	T cells
AGGCCACAGTGTCCCG-1	T cells
TAGAGCTTCCGAGCCA-1	T cells
TCACGAAAGCAGATCG-1	T cells
TAAGAGATCGTAGGAG-1	T cells
CACAGGCAGCTCAACT-1	T cells
TAAGCGTCACTGAAGG-1	T cells
ATTTCTGGTGACAAAT-1	T cells
CTAGCCTTCTGTACGA-1	Monocytes
GGCGTGTAGTAAGTAC-1	B cells
TTAGGACTCAGCACAT-1	T cells
GAAACTCCAATAACGA-1	T cells
CGTCCATCATTAACCG-1	T cells
GACAGAGGTGATAAAC-1	T cells
TTGAACGAGTCAAGGC-1	T cells
CAACTAGCAACTGCGC-1	T cells
TCACAAGTCCAAACAC-1	NK cells
AGCTCTCAGAGTCTGG-1	T cells
TCACAAGGTTTGTGTG-1	T cells
TCAACGATCTCAACTT-1	Monocytes
GTAACTGGTCGTGGCT-1	T cells
TCTGGAAAGCGAAGGG-1	mDCs
GAACATCGTATAAACG-1	Monocytes
CATATGGAGTCGATAA-1	T cells
AGATTGCGTCAACATC-1	Monocytes
TGACAACGTGAGTGAC-1	Monocytes
CGTAGGCGTATAGGGC-1	T cells
TGATTTCTCATGCATG-1	Monocytes
AGATCTGGTATGAATG-1	B cells
ATGCGATAGGCGATAC-1	T cells
ACGTCAAAGACGCTTT-1	T cells
ATCCGAAAGTTTAGGA-1	T cells
TGGCGCAGTCATGCCG-1	Monocytes
TTAGGCATCCCATTTA-1	T cells
ACTGATGCACCTGGTG-1	T cells
CTCCTAGAGTACGTTC-1	Monocytes
ATTCTACTCATCGCTC-1	T cells
AAAGTAGAGACAATAC-1	T cells
CATCAGACACTCGACG-1	T cells
CTCGTACCATTAACCG-1	mDCs
TACTTACCAGACAAGC-1	T cells
TCTATTGCATACTCTT-1	T cells
GGGTCTGTCGTAGATC-1	Monocytes
ATTCTACGTTCGCGAC-1	Monocytes
GCTGCGATCAAGCCTA-1	B cells
CGCGGTATCGCACTCT-1	B cells
AGTTGGTTCTGCGGCA-1	B cells
ACTGAGTGTCCTAGCG-1	T cells
GACACGCCACACCGAC-1	B cells
ACTTTCAAGCTAGTCT-1	T cells
ACTGAGTTCGAATCCA-1	T cells
ATCCACCAGCGATCCC-1	T cells
GACCTGGAGCCCAACC-1	B cells
CAGCCGAAGATCCCGC-1	B cells
AAAGCAATCTGCCCTA-1	mDCs
CCGTTCATCTCGAGTA-1	B cells
GATGAAACACAGACTT-1	Monocytes
AGGGATGGTTTGACAC-1	B cells
TTTGCGCGTAATAGCA-1	T cells
CAGAGAGTCGTCTGCT-1	Monocytes
ATCCACCTCTAACGGT-1	T cells
GTATCTTTCCCAGGTG-1	T cells
CGAGAAGTCCGTCATC-1	Doublets
TGCCCTAGTTATCGGT-1	T cells
GCATGATGTTGATTGC-1	T cells
TGACAACGTGCGATAG-1	T cells
CATCGGGTCATGTCTT-1	B cells
CTTAACTAGCTACCTA-1	Monocytes
GATGAGGGTTCAGACT-1	T cells
GCTGCAGTCTGCCAGG-1	T cells
TGTGGTAGTTACGACT-1	Doublets
ACTGTCCAGCTCCTTC-1	T cells
AGGGTGAGTGTATGGG-1	B cells
TCGCGTTCATCGATTG-1	T cells
CATTCGCGTACCGCTG-1	T cells
CTGATCCGTCTAACGT-1	T cells
ATCGAGTGTCGTGGCT-1	B cells
CAGTAACAGAGCTGGT-1	T cells
GGCGTGTGTATTAGCC-1	T cells
GCCAAATTCTAAGCCA-1	Monocytes
TGAGGGATCTGCCCTA-1	Monocytes
CTACCCAGTAAGTTCC-1	T cells
GCAAACTCAATTCCTT-1	T cells
TGAGCCGAGACATAAC-1	NK cells
ACGGAGATCGTGACAT-1	NK cells
GAACGGAAGCTACCGC-1	Monocytes
ACTGCTCAGCCAGTAG-1	B cells
GGCGACTCATGGATGG-1	T cells
GAGGTGAAGTCTTGCA-1	B cells
CGGAGCTCAAGGTTCT-1	T cells
AAAGTAGAGTCAAGGC-1	Monocytes
GACGGCTCATACGCCG-1	T cells
GCAATCAGTAACGTTC-1	NK cells
ACGGGCTGTCTTCTCG-1	Monocytes
TTCTCCTAGCACCGCT-1	B cells
AGACGTTCATAGAAAC-1	T cells
CGTGAGCCATGGTAGG-1	T cells
CGGACTGTCGGCGGTT-1	NK cells
CGGTTAAAGTTTCCTT-1	Monocytes
CACCAGGTCGGACAAG-1	T cells
CAAGATCAGATACACA-1	B cells
GCTGCTTAGGCTAGAC-1	T cells
ATTACTCGTGAACCTT-1	T cells
AGTCTTTCAAAGTCAA-1	NK cells
CAGCTAAGTCCGACGT-1	T cells
TGACTAGAGTTTCCTT-1	Monocytes
CCGGGATGTGCCTGTG-1	Doublets
CGTCTACCAAGGTTCT-1	T cells
TCTTTCCTCCCAGGTG-1	NK cells
GGCCGATGTTGGTAAA-1	T cells
GGGTTGCTCTGTCCGT-1	Monocytes
AAAGCAAGTCTCACCT-1	Monocytes
GCACATATCCGTTGCT-1	NK cells
GACCTGGCATGACATC-1	T cells
GAGTCCGCAGTCGTGC-1	T cells
TTGCCGTCAGCGTAAG-1	T cells
TTAGTTCCAAACCCAT-1	B cells
CCATGTCAGCCACCTG-1	NK cells
ACTTACTTCAGTTCGA-1	T cells
TTTCCTCCATAGGATA-1	Monocytes
GTATTCTAGAAAGTGG-1	T cells
CCTACACGTCTTCGTC-1	Monocytes
AGAATAGAGACAAGCC-1	B cells
AGTAGTCGTTGATTCG-1	T cells
CGCTTCAAGACTAAGT-1	T cells
GGCGTGTGTTGAACTC-1	Monocytes
GCGCGATTCGTCTGAA-1	Monocytes
GACGGCTTCGAATGGG-1	NK cells
CTACACCGTCCTCTTG-1	T cells
CATCGAATCTGCGGCA-1	mDCs
GGCTGGTAGATACACA-1	T cells
ATCCGAACACACTGCG-1	T cells
GTACTTTTCGGATGTT-1	T cells
GCACATAAGGCCATAG-1	T cells
GGCAATTGTTCCATGA-1	T cells
GGACAAGCAGCGTAAG-1	Monocytes
CAGCGACCACACAGAG-1	T cells
GACTAACTCTTACCGC-1	T cells
CACACTCGTACGACCC-1	T cells
CGTCTACGTCATATCG-1	T cells
GACCAATGTATAAACG-1	T cells
TAGTGGTAGAAGGTGA-1	mDCs
CAAGAAACAGTCGATT-1	NK cells
GTCTCGTTCCTATGTT-1	NK cells
CATTATCGTAAGCACG-1	T cells
AGAGCGACACGTCTCT-1	Monocytes
GGACAGACAGATGGGT-1	T cells
TCTGGAATCCTCCTAG-1	Monocytes
AAGACCTAGCACCGTC-1	T cells
AAATGCCAGGGTATCG-1	T cells
ACGAGCCTCTCTGAGA-1	Monocytes
TACTTGTGTGCCTGGT-1	T cells
TCAGCTCGTTGTACAC-1	T cells
CTCGGGAGTTCAGCGC-1	Monocytes
TATCAGGAGGTAGCTG-1	T cells
ACTGATGCATTCCTGC-1	Monocytes
TCAGCAAAGCTTATCG-1	NK cells
GACAGAGCAGATGGCA-1	Monocytes
CAGCATACAAGTTAAG-1	T cells
AAAGATGAGACATAAC-1	T cells
TTAGGACTCTAACGGT-1	NK cells
CCAGCGATCAGTTTGG-1	T cells
ACTTTCACATCCCACT-1	B cells
CTCGTCAGTGCCTGCA-1	B cells
AGATTGCTCAACGCTA-1	Monocytes
TACTTACTCTTCTGGC-1	T cells
TTGCGTCTCTACCTGC-1	B cells
GACACGCGTGAGTGAC-1	B cells
CTCGTACCAAAGAATC-1	T cells
CCCTCCTAGGGATGGG-1	T cells
CTACGTCGTTGTACAC-1	T cells
CTCGAAACAGTGAGTG-1	Monocytes
CATATGGAGCTCCTTC-1	Monocytes
TGACGGCTCATCTGTT-1	T cells
GGAACTTTCATATCGG-1	T cells
CGCTTCAGTTATGCGT-1	T cells
CTGTTTAGTCCGTCAG-1	Doublets
GTTCTCGTCACCGGGT-1	B cells
GCATGATGTAGGCTGA-1	T cells
AAAGATGGTCCCTACT-1	B cells
CCCTCCTAGACATAAC-1	B cells
ACGGGTCCAGGGAGAG-1	T cells
CGTCTACCACAAGCCC-1	T cells
ATTGGACGTCTTCGTC-1	Monocytes
CCGTTCATCTCGTTTA-1	Monocytes
GACCAATCAGACAAAT-1	T cells
CCTCAGTGTATGAATG-1	T cells
TACCTATAGTGGTCCC-1	NK cells
CTACGTCGTGTGACCC-1	Monocytes
GGCTCGAAGGCTCATT-1	T cells
CGATTGATCAGGTTCA-1	T cells
CATATTCGTCATGCCG-1	B cells
CCTTTCTTCCACGCAG-1	T cells
TCAGCAAGTGCCTGTG-1	B cells
TACTTGTTCGCAGGCT-1	B cells
ACTGTCCAGCCACGTC-1	B cells
TAGTGGTTCGCCTGTT-1	Monocytes
CCGGGATCAGAGCCAA-1	B cells
GATCGATGTGCCTGCA-1	Monocytes
CGTTAGAAGCAAATCA-1	Monocytes
ATCATGGAGCTGCGAA-1	T cells
GACTAACCACACCGAC-1	B cells
TGATTTCAGTGGGCTA-1	mDCs
CATCCACAGTTGTCGT-1	Monocytes
GCGCAACCAGTCAGCC-1	T cells
ATGAGGGAGCGTGTCC-1	Monocytes
AGGTCATCATTGGCGC-1	B cells
GACTAACTCGAACGGA-1	T cells
ACCAGTAGTGGTTTCA-1	T cells
AATCCAGTCCCAGGTG-1	B cells
TGGGAAGGTCTAGGTT-1	Monocytes
GAAACTCGTTGTACAC-1	B cells
GCCAAATCATGCAACT-1	T cells
GGCGTGTGTAAGCACG-1	Doublets
TGCCCTATCGCAAGCC-1	B cells
ACCAGTATCGCGTAGC-1	Monocytes
AACACGTTCGCATGGC-1	T cells
TTAACTCTCACCGTAA-1	B cells
GGATTACAGTGGAGAA-1	T cells
CAGAATCCATCTCGCT-1	B cells
CGATGGCAGCTAAACA-1	T cells
CATCGGGCATGTCTCC-1	T cells
CGTTGGGAGGAATGGA-1	Monocytes
TACGGATCAATGAAAC-1	T cells
AACTTTCTCAAGGCTT-1	B cells
GTATTCTTCAAGAAGT-1	T cells
TCTCTAATCAGGTAAA-1	B cells
GAACGGAGTCAACATC-1	T cells
TTGGAACGTCTTCGTC-1	T cells
ATGTGTGGTCTTCAAG-1	T cells
CTTCTCTGTTACTGAC-1	T cells
ATGCGATAGCTAGTGG-1	NK cells
TAAGAGAAGCTGTCTA-1	T cells
CCATGTCGTAAGTGTA-1	Doublets
GTACGTACATCGGAAG-1	T cells
CCGGTAGGTGCGCTTG-1	NK cells
ATGCGATGTACATGTC-1	NK cells
GTATCTTCAGGATCGA-1	NK cells
TCTCATAAGTTGCAGG-1	T cells
CAGAGAGTCGAATGCT-1	T cells
TATCAGGTCGTCTGAA-1	T cells
GAGCAGACACGACTCG-1	B cells
CCTCAGTTCAGCTTAG-1	T cells
CCTTCCCGTTACCAGT-1	T cells
CCGGGATCAGGTGCCT-1	Monocytes
CGTGAGCTCAGTGTTG-1	Monocytes
TGGACGCAGTGCGTGA-1	T cells
TTGTAGGCAAGCTGTT-1	T cells
GGTGTTATCCTTTACA-1	Doublets
AACTTTCCAATACGCT-1	B cells
TAGCCGGTCGCAGGCT-1	T cells
CCTTACGTCTGCGGCA-1	Monocytes
CAGCTAATCGCTAGCG-1	T cells
AGCGGTCAGCTCCCAG-1	Monocytes
ACCAGTATCTCATTCA-1	mDCs
AGCAGCCTCTGTACGA-1	T cells
GGAACTTAGTTCCACA-1	Doublets
AGATCTGCACCAACCG-1	T cells
CGGACACAGACGCAAC-1	Monocytes
CGGGTCAAGGACAGAA-1	T cells
CGTTGGGAGGTGCTAG-1	T cells
GTCGGGTTCACGGTTA-1	mDCs
CTGCGGATCTCCGGTT-1	T cells
GCATGTATCTTGCAAG-1	T cells
CAAGGCCTCTCGCTTG-1	NK cells
AATCCAGCAAAGAATC-1	B cells
CAACTAGGTGCACTTA-1	Monocytes
TGAGCATCAGTATGCT-1	T cells
GACTACAGTGTTAAGA-1	T cells
CAGGTGCGTGTGGCTC-1	T cells
TGCTGCTGTTCGAATC-1	T cells
AACTCTTTCTCTTATG-1	B cells
CGAGAAGTCACCTCGT-1	T cells
CTCAGAACAATCTGCA-1	T cells
AGCCTAAGTAGAAGGA-1	Monocytes
GCATGATCACCAGCAC-1	Monocytes
ATCTGCCCACCAGATT-1	T cells
AGCGTATCAGGCTGAA-1	T cells
ACACCCTCATGCAATC-1	T cells
TTTACTGAGTACGTTC-1	B cells
TCGCGTTAGCATCATC-1	T cells
GTACTCCGTTAGGGTG-1	T cells
GGAGCAATCGCTTGTC-1	Monocytes
CCACTACTCATGTAGC-1	T cells
ACCTTTACATGTTGAC-1	T cells
CATCGGGCATTATCTC-1	T cells
CCTCTGATCCGTAGTA-1	T cells
TCGTAGATCGCCTGAG-1	T cells
GGCTGGTTCGTTGCCT-1	T cells
TGAGGGAAGTACCGGA-1	Monocytes
CAACCAACAGGGTTAG-1	Monocytes
ATCCACCCAAGTCTGT-1	T cells
CATGGCGTCCATGAGT-1	T cells
TTCGGTCGTTGTCGCG-1	Monocytes
CGGCTAGGTTCGCTAA-1	T cells
GCATGCGGTCTGCGGT-1	Monocytes
ATGTGTGGTCCCTACT-1	Monocytes
AAGGAGCGTTGAGGTG-1	B cells
TTTGGTTGTTATCACG-1	T cells
CGACTTCCAATCCGAT-1	Doublets
CTGCCTAAGTGCGATG-1	T cells
AGCAGCCCAGACACTT-1	NK cells
AGCTCTCAGTTACGGG-1	T cells
AGCGTCGCACGGTGTC-1	T cells
ACACCCTCATCTCCCA-1	Monocytes
ATTGGACAGTGACATA-1	T cells
ATCACGACAACACCTA-1	B cells
AAACGGGGTCTTCTCG-1	Monocytes
CTAGTGAAGCCGGTAA-1	T cells
GAACATCGTATTAGCC-1	T cells
CCCAATCAGAATTCCC-1	Monocytes
TAAGAGAGTGCCTGTG-1	T cells
CTCAGAAAGTAGCGGT-1	B cells
CAGCCGAAGCGTAATA-1	Monocytes
AAGGTTCTCCATGAAC-1	T cells
TTCTCCTGTACAGCAG-1	B cells
ACGTCAAAGGCCCTCA-1	Monocytes
TCGAGGCAGGTAGCTG-1	T cells
TGCCAAACACATTAGC-1	T cells
GCGAGAATCGACGGAA-1	B cells
TCTATTGCAAGCGAGT-1	T cells
TTGCGTCTCTCGCTTG-1	T cells
AGATCTGGTTATCCGA-1	T cells
ACACCCTGTCGCTTTC-1	T cells
GCGAGAATCAGCACAT-1	T cells
AACGTTGGTTGGTGGA-1	Doublets
AGAATAGTCCAGATCA-1	Monocytes
ACTGAACGTTTGTGTG-1	B cells
GCGCAACAGGCGTACA-1	Monocytes
TTGTAGGAGGATGCGT-1	T cells
TGAGGGAAGAAACCTA-1	Monocytes
CGGGTCAGTCAACTGT-1	B cells
CTCTGGTTCTATGTGG-1	B cells
TCAGCTCTCGCCTGTT-1	T cells
ACATGGTAGTCTCAAC-1	T cells
GACGTGCGTAAATACG-1	Monocytes
CTCGGAGAGCGAAGGG-1	T cells
ACACTGAAGCGGCTTC-1	T cells
GGGAATGGTACTTGAC-1	B cells
ACAGCTATCAACGGCC-1	T cells
CTCATTATCAGTCCCT-1	Monocytes
GGTGAAGCAATGACCT-1	mDCs
TTCTCCTAGCTAACTC-1	Monocytes
TTCTCAAAGTTGTCGT-1	T cells
AGTCTTTGTCGCTTCT-1	T cells
GACAGAGAGTACGTAA-1	T cells
CAGTAACCAATGGTCT-1	NK cells
GTCCTCATCTGAGTGT-1	T cells
GGATTACAGTCAATAG-1	NK cells
AGTGGGATCACTTACT-1	T cells
GCTGGGTCACCTCGTT-1	NK cells
CCGTACTTCGATAGAA-1	T cells
TGACAACGTCTAGAGG-1	T cells
CGATTGAGTACTTCTT-1	Monocytes
GACAGAGTCTAGAGTC-1	Monocytes
CGCGGTAGTAGGGTAC-1	T cells
GAGCAGAGTTGTGGAG-1	T cells
CCCAGTTGTGAACCTT-1	T cells
CTCACACTCTACGAGT-1	T cells
CTACATTAGAGCTTCT-1	Monocytes
GGACAAGTCATAAAGG-1	T cells
TGCCCATGTTATTCTC-1	T cells
GCACTCTTCAGTTTGG-1	T cells
ACGATACAGGAACTGC-1	T cells
AGAGCTTTCAGTCAGT-1	Monocytes
GGGCATCAGACACGAC-1	Monocytes
CGGACGTGTCTTTCAT-1	Monocytes
TGCGCAGAGCTTCGCG-1	Monocytes
TACGGTACACCCTATC-1	T cells
ACTGCTCTCGGCTACG-1	T cells
ACAGCTAAGTTAGGTA-1	T cells
TCAGGATAGCGGATCA-1	T cells
CTCCTAGTCCGCATCT-1	Monocytes
AGAATAGGTGGTCTCG-1	NK cells
AACTGGTGTTTCGCTC-1	T cells
CACAGGCAGAAACCGC-1	Monocytes
TGCGCAGGTATCACCA-1	T cells
GTCTTCGGTTCTGTTT-1	T cells
GGAATAACAGGCTGAA-1	Monocytes
GCCAAATTCTGCAGTA-1	T cells
CCCAATCGTTGCGCAC-1	T cells
GTATCTTAGGCTCAGA-1	Monocytes
GCCTCTACATGTCCTC-1	T cells
CATTCGCCATATACCG-1	T cells
GGAACTTTCGATCCCT-1	T cells
CAAGATCTCATCGGAT-1	Monocytes
GGCTGGTGTTGATTGC-1	T cells
GGACAGACAGTCAGAG-1	B cells
CGGCTAGAGCTTCGCG-1	T cells
CTGAAGTTCCACGTGG-1	mDCs
ATCCACCGTATCAGTC-1	T cells
CACCAGGGTATTCTCT-1	pDCs
CTCATTACAGGGCATA-1	T cells
GTGGGTCAGAGAACAG-1	Monocytes
ACTGTCCCATGTCGAT-1	B cells
GCGGGTTAGCGTTTAC-1	Monocytes
TGACTTTAGAGATGAG-1	T cells
GCATGCGAGACTGGGT-1	T cells
TTTACTGAGCGTAATA-1	Monocytes
CCTACCACAATAGCGG-1	T cells
TACTCATTCAGTTCGA-1	T cells
TTTGCGCCATTTGCTT-1	T cells
CAAGAAAAGCTGCGAA-1	T cells
CGAACATAGCTGAAAT-1	Monocytes
AACTCAGGTGCACTTA-1	T cells
GACGTTACATGTCGAT-1	T cells
CTCATTATCATTTGGG-1	T cells
CCGTTCAGTCACTGGC-1	B cells
CCTATTACACGAAGCA-1	NK cells
TTCGAAGAGATATGCA-1	T cells
TTGAACGCAACTGGCC-1	T cells
TGCTACCTCGCTTAGA-1	NK cells
ATGGGAGCATCAGTCA-1	B cells
GGCTGGTGTTATGCGT-1	NK cells
ACACCGGCAACCGCCA-1	T cells
TGTGTTTTCCGCGGTA-1	T cells
CACAGTAGTCTGCCAG-1	Monocytes
GGCCGATAGGTACTCT-1	mDCs
ATGCGATAGGCTAGCA-1	T cells
CACCAGGCATGGATGG-1	B cells
TGCCAAAGTCGAATCT-1	T cells
ATTGGTGGTTACGACT-1	T cells
ACAGCTAGTATTAGCC-1	T cells
GAAGCAGTCCCTAATT-1	T cells
CAACTAGCACACCGAC-1	Monocytes
CTACCCACACCCTATC-1	T cells
CTCCTAGAGCAGACTG-1	B cells
GATGCTAGTTGAGTTC-1	B cells
TAAGCGTGTCCCGACA-1	T cells
AAGGAGCGTACGCACC-1	T cells
GCTTGAATCGCTAGCG-1	T cells
ACACTGAGTGGTGTAG-1	Monocytes
CCTAAAGTCTGTCTCG-1	B cells
TTTCCTCTCACAATGC-1	T cells
AGAGCGAGTTCCACTC-1	T cells
TTTGCGCTCGATAGAA-1	T cells
CGGAGCTTCTTAACCT-1	B cells
CGTCCATTCGTGGTCG-1	T cells
TTAACTCGTATGAATG-1	Monocytes
TGGGAAGCAAGAAGAG-1	T cells
AGACGTTGTTCCTCCA-1	T cells
TGAAAGATCTGCGACG-1	T cells
GTAGTCAGTCTTGCGG-1	pDCs
AGCTCCTTCTTACCGC-1	T cells
CGTTCTGTCCGAGCCA-1	Doublets
ACTGAGTAGAATTCCC-1	T cells
GCTTCCAAGCTTATCG-1	T cells
CATATTCGTGCCTTGG-1	NK cells
ATCGAGTTCGCAAGCC-1	B cells
CTACGTCGTCAGATAA-1	Monocytes
CACAAACTCTTAACCT-1	T cells
GATGAGGAGTCATGCT-1	B cells
CGGACTGGTGTTCGAT-1	T cells
TATCTCATCCAAACTG-1	T cells
GTCTCGTTCAAAGACA-1	T cells
ACTGAACCAAGCCGTC-1	Monocytes
TGGCTGGCAGTATAAG-1	T cells
TGAGCCGAGACAGGCT-1	Monocytes
CCAGCGATCGGAAACG-1	Monocytes
GGCAATTAGCGTGAAC-1	Monocytes
GTGGGTCAGACCCACC-1	Monocytes
TCTCATACACATCCGG-1	T cells
CGGTTAAAGAGTTGGC-1	Monocytes
ACTGAACTCTTTAGTC-1	mDCs
TTGTAGGAGTACGCGA-1	Monocytes
TGACAACAGCGATTCT-1	Monocytes
CTGGTCTTCCAAACAC-1	mDCs
AGCTCTCCAGCTTCGG-1	Monocytes
AGATCTGGTCCTGCTT-1	Monocytes
TCGGTAAAGTTTCCTT-1	B cells
CGATGTAAGTTCGCGC-1	Monocytes
TGTTCCGAGCGCTCCA-1	mDCs
TCGTACCAGTATTGGA-1	Monocytes
CTGATAGGTGCTGTAT-1	Monocytes
TACGGATAGAAACGAG-1	Monocytes
CTTGGCTTCTGGTTCC-1	Doublets
GTACGTACAACAACCT-1	T cells
CAACTAGTCCTCTAGC-1	T cells
ACCCACTTCGAGAGCA-1	T cells
AAACCTGGTACATCCA-1	B cells
AAACGGGAGCGGCTTC-1	mDCs
CAGCTGGTCGGCATCG-1	NK cells
CGAGCACTCTTTACAC-1	B cells
AAACCTGAGGCATGGT-1	T cells
AGGGATGCAGCATACT-1	T cells
GCGCAGTCAGCGTAAG-1	pDCs
CATTATCCAAATTGCC-1	Monocytes
GGAATAACACAGCGTC-1	T cells
ACCAGTAGTACAAGTA-1	T cells
CTGTTTAGTAAATACG-1	T cells
ACTGCTCAGGGTATCG-1	Monocytes
TACAGTGGTCGACTGC-1	T cells
CTCATTACAGGTCCAC-1	T cells
CTCGGGACACCTGGTG-1	T cells
GCTGCTTAGGACCACA-1	T cells
CTCGTACTCATTTGGG-1	T cells
CCGGTAGAGCTGCAAG-1	Monocytes
GTAGGCCCACTAGTAC-1	T cells
TGCCCTATCTTCATGT-1	T cells
CGTGTCTTCCAGATCA-1	Monocytes
CGGACACTCGGTCCGA-1	T cells
GATGAGGGTAACGCGA-1	T cells
TAGAGCTAGACAATAC-1	T cells
ACCAGTAGTTGACGTT-1	T cells
TACAGTGCAACTGGCC-1	T cells
GCCTCTAAGAGCAATT-1	T cells
GGATGTTTCATACGGT-1	Monocytes
ATGTGTGAGCCCTAAT-1	T cells
TTCGAAGGTGAGGCTA-1	T cells
ACAGCCGCAGTTCATG-1	B cells
TAGTTGGTCTTGAGGT-1	T cells
GTCTTCGGTTCCACTC-1	T cells
AGAATAGTCCTATTCA-1	mDCs
ACTTGTTGTGACGCCT-1	T cells
AACCATGGTACAGCAG-1	Monocytes
AAGTCTGAGCGGATCA-1	NK cells
ACACCAAAGTTTCCTT-1	T cells
CTAGTGAGTTGTCTTT-1	Monocytes
ATCCACCCAAGCGCTC-1	B cells
GCACTCTCATGAGCGA-1	B cells
CAGTAACCATGCGCAC-1	Monocytes
AGCCTAACAATGTAAG-1	T cells
AGTGTCAGTTACGACT-1	T cells
AGCTTGAGTAGGGTAC-1	Monocytes
AAACGGGAGGCTAGCA-1	T cells
TTGGCAACAATGAAAC-1	T cells
GATGAAAGTACACCGC-1	B cells
CACCACTTCACAGGCC-1	T cells
ATCTGCCAGACAAAGG-1	T cells
CGGTTAATCCTGTACC-1	NK cells
AAGCCGCAGGCCATAG-1	T cells
ACGGCCAGTCTCATCC-1	T cells
TGGTTAGCACATGGGA-1	T cells
CATGACAGTACCGAGA-1	mDCs
CTGCCTACAAAGCAAT-1	T cells
CATATGGGTTTAAGCC-1	NK cells
CGATCGGCAAACAACA-1	T cells
TTCTACAGTGACTCAT-1	T cells
GGTATTGTCCTCTAGC-1	Monocytes
TGACTTTAGACAAGCC-1	B cells
AGGTCATAGCTAAGAT-1	T cells
ACCTTTAAGTATTGGA-1	T cells
CTGAAGTGTTGACGTT-1	T cells
CTCTGGTAGACTTTCG-1	mDCs
GTGTTAGCAAACAACA-1	B cells
TTAGGCACATGGGAAC-1	T cells
CAAGGCCGTCGCTTTC-1	T cells
AAGGTTCCACCGTTGG-1	T cells
AAATGCCCACATTTCT-1	T cells
ATTGGTGGTCCGTCAG-1	Monocytes
AACCATGAGGAGCGTT-1	T cells
GGGAGATTCCTTTCGG-1	T cells
TCTGGAAGTTCAGTAC-1	T cells
CTCGGAGTCCTATGTT-1	T cells
ACGGGCTGTGTTGAGG-1	B cells
TCTGAGAGTCACTGGC-1	NK cells
GCTGCAGCACAGTCGC-1	B cells
GGGAGATCAGCTGTGC-1	T cells
GCATGATCAGTCGATT-1	T cells
CCGTACTCACGAGAGT-1	T cells
GGCGTGTCAAGCGTAG-1	B cells
ACTGATGCAAGTTAAG-1	Monocytes
TCTCATATCTGGTTCC-1	T cells
CCCATACCACCATCCT-1	T cells
GTTAAGCGTCGCATAT-1	T cells
TCTTTCCGTTTGTTGG-1	Monocytes
ATGCGATTCAGGATCT-1	B cells
ACGGCCAAGTGACTCT-1	Monocytes
CCATGTCCACTTACGA-1	B cells
CATCAAGGTGGCAAAC-1	Monocytes
CGCTTCATCATGCATG-1	Monocytes
GGGATGATCATAAAGG-1	T cells
TCTCATAAGTTAGCGG-1	Doublets
GCGCAACCAGGTGGAT-1	T cells
AAGTCTGCACTGTTAG-1	T cells
TACGGTACAGCTGTGC-1	B cells
CTGATCCTCATATCGG-1	Monocytes
TTTGCGCGTGTTCTTT-1	Doublets
TCATTTGAGCAAATCA-1	mDCs
TCTATTGTCATCTGTT-1	T cells
AGATCTGCAAAGCGGT-1	T cells
TAAACCGAGGCATTGG-1	T cells
CATTCGCAGACCTAGG-1	B cells
CCACTACGTCGAAAGC-1	T cells
GCATGATGTTAAGTAG-1	T cells
GTCACGGTCAGTCAGT-1	NK cells
TGCCAAACATGACATC-1	T cells
TTGACTTTCGTTGCCT-1	T cells
CGTTGGGCATAAGACA-1	T cells
TGGCTGGTCATTATCC-1	T cells
CCTAGCTGTTGAGGTG-1	T cells
TAGTTGGTCAGCCTAA-1	Monocytes
AACCGCGAGATCCCAT-1	pDCs
ACGGCCATCCTTTACA-1	Monocytes
TCGTAGAGTGCGAAAC-1	Monocytes
AAGGCAGTCCGCATCT-1	T cells
CGGCTAGCAGATAATG-1	T cells
TATTACCTCTCATTCA-1	T cells
ATTGGACTCCTCATTA-1	Doublets
GCATGTACAGTTTACG-1	Monocytes
GAAGCAGAGAAAGTGG-1	T cells
AACTCAGTCAGAGCTT-1	NK cells
TTGACTTTCGTCCAGG-1	T cells
ACGCCAGAGTACGTAA-1	T cells
GGGACCTTCACGACTA-1	T cells
TCACAAGGTTGTGGCC-1	T cells
GCACTCTTCAGTCCCT-1	T cells
TAGCCGGCATCCCACT-1	Monocytes
CACATAGGTGAAGGCT-1	T cells
GACCAATAGTGACTCT-1	B cells
CATGACAAGTGTACTC-1	T cells
GTACTTTTCGAGCCCA-1	T cells
ACCTTTAAGCAGCGTA-1	Monocytes
CGTGTAACAGTTCCCT-1	T cells
CCGGGATCATCGATTG-1	T cells
GCGCAACGTTGCGCAC-1	B cells
ACCCACTAGCTAGTGG-1	T cells
GATGAAATCCAGTAGT-1	Monocytes
CAGCAGCGTTTACTCT-1	Monocytes
AGCGTATGTGTAACGG-1	T cells
GGAACTTCAGACAAGC-1	B cells
CACACCTGTTAGAACA-1	NK cells
AAACCTGCAAGGTTCT-1	T cells
GTGCAGCAGCTTTGGT-1	T cells
GAATGAAAGCCAGTAG-1	T cells
TAAGAGACACATTCGA-1	Monocytes
GGCGTGTAGCTAGTCT-1	T cells
AGGTCCGTCCTAAGTG-1	B cells
ACGCCAGGTACTCTCC-1	B cells
CACCTTGTCGTGGTCG-1	T cells
CCTAGCTTCTTATCTG-1	T cells
TGAAAGACATCTCCCA-1	Monocytes
CTGTGCTGTAAACCTC-1	Monocytes
AATCGGTGTTCCATGA-1	T cells
TCAGGTAAGGAATTAC-1	Monocytes
TAAGTGCAGCTGAAAT-1	T cells
CGACCTTAGACCCACC-1	T cells
CTGTGCTAGAGGTAGA-1	pDCs
TCAGGATGTTGGTAAA-1	T cells
TCGCGAGCAGACAAAT-1	T cells
CGATTGAAGGCTAGCA-1	T cells
ATTGGACAGAGTACAT-1	T cells
GGCAATTGTAGCACGA-1	mDCs
TATGCCCGTTAGGGTG-1	NK cells
AGTAGTCTCACCTCGT-1	T cells
TTCGGTCAGCGTTCCG-1	T cells
CACAGTAAGAGGTTAT-1	T cells
GCCTCTAAGCAGCGTA-1	T cells
GGACGTCGTCGTTGTA-1	T cells
CGGACTGGTGGAAAGA-1	Monocytes
ACGCAGCGTGTGGCTC-1	T cells
CGCTATCCAGGTGCCT-1	T cells
CGTCACTTCTGAAAGA-1	T cells
TCAGCAAGTGCTTCTC-1	T cells
ATAAGAGCACCCAGTG-1	T cells
GTGCAGCCATTCGACA-1	T cells
ATGAGGGCATATGGTC-1	T cells
ATAGACCTCTCACATT-1	T cells
TACGGGCCAGGGCATA-1	T cells
TCGCGTTTCGACAGCC-1	Monocytes
CCCAGTTCAAATCCGT-1	NK cells
CCGTTCACACCCATGG-1	T cells
ACTTTCACAAGCTGAG-1	B cells
GTACGTAGTAAGTTCC-1	Monocytes
TCAGCTCCAGATGGCA-1	T cells
ATTCTACCAAGTAGTA-1	B cells
ACGATACGTCGGCATC-1	T cells
TCTGAGATCAAGATCC-1	Monocytes
TGCCAAATCGAGAGCA-1	Monocytes
GACTGCGGTAATCACC-1	T cells
TTTGGTTCATTGGCGC-1	T cells
TAGTTGGAGAACTCGG-1	T cells
CAAGGCCCAGGGATTG-1	T cells
GATGAGGGTCGAACAG-1	B cells
CACATAGCAAGACGTG-1	T cells
CCTAAAGCATACTACG-1	T cells
GTTCGGGGTCATACTG-1	T cells
AGTGGGACAGCTTCGG-1	T cells
AGGGTGATCCCAACGG-1	T cells
TAGACCATCAGGATCT-1	Monocytes
AGGGAGTCACATGACT-1	T cells
GGCTGGTCAGTCGATT-1	Monocytes
AGTCTTTCATTGGCGC-1	T cells
GATTCAGGTGGCGAAT-1	T cells
CAGGTGCCACTGTGTA-1	T cells
TGTCCCAGTTCCACTC-1	T cells
CATATTCGTATGAAAC-1	T cells
GCGCCAACATTCACTT-1	T cells
GTCTCGTTCATCTGTT-1	T cells
CAGGTGCGTAAATGAC-1	T cells
CCTCAGTGTAAGGGAA-1	Monocytes
CACAAACGTCAAAGAT-1	NK cells
CTACGTCGTAAGGGAA-1	B cells
CTCACACGTTTAAGCC-1	T cells
CTAGAGTCACGTCAGC-1	T cells
ACTGAGTTCGCCAGCA-1	Monocytes
GATCGCGTCAGTTTGG-1	T cells
GCTCTGTCATTCGACA-1	T cells
ATTGGACTCTTGTACT-1	B cells
ATTACTCAGTGATCGG-1	B cells
GGATGTTGTATCGCAT-1	NK cells
TGAGCCGGTCTACCTC-1	T cells
ACGAGGAAGCTAACTC-1	T cells
TCAGGTATCCGTTGTC-1	B cells
CCACCTAGTGAACCTT-1	T cells
GCAGTTACACGAAACG-1	T cells
AGTCTTTAGCACAGGT-1	T cells
CAGCCGACAGTCGATT-1	B cells
TCTGAGAGTATGCTTG-1	NK cells
CACAGGCGTGATGTCT-1	mDCs
ACCCACTTCAGTCAGT-1	T cells
CTCTGGTCAAATCCGT-1	T cells
CCGGTAGGTAGCCTAT-1	T cells
GAAATGATCACTCCTG-1	T cells
CAGAGAGAGGTCGGAT-1	T cells
ACGCCGATCAGGATCT-1	Monocytes
CGCGTTTGTACTCTCC-1	NK cells
CCATTCGTCGGTTAAC-1	T cells
TGTCCCAGTCGCTTTC-1	B cells
GTTCGGGGTTCACCTC-1	T cells
CTGCGGAAGTACGCGA-1	Monocytes
ATTTCTGAGTCATGCT-1	T cells
CAAGTTGTCTGCTTGC-1	T cells
GGGCACTAGGTGATTA-1	Monocytes
GTACGTAAGGGTCTCC-1	T cells
ATAGACCGTGTCAATC-1	T cells
GGCGACTGTTAGATGA-1	T cells
TTCGAAGCAGGGCATA-1	Monocytes
GTTACAGGTCGCATCG-1	T cells
AGCGTCGGTGTTCGAT-1	mDCs
ACGTCAAGTCTAGGTT-1	Monocytes
ACGAGCCGTTGGTAAA-1	T cells
GGGTCTGCAACACCCG-1	Monocytes
GATCGCGGTGACGCCT-1	B cells
CTCGAAAGTCAATGTC-1	T cells
CGTAGCGAGAATGTTG-1	T cells
GTTCTCGCACTAAGTC-1	T cells
CAGAATCAGCGACGTA-1	Monocytes
TCACGAATCCTACAGA-1	T cells
TCGGGACTCCCAACGG-1	T cells
CTGGTCTTCAACACAC-1	T cells
GTAGGCCTCCAGTATG-1	T cells
AGTAGTCGTAGAGCTG-1	T cells
CACATTTGTACCGTAT-1	T cells
CCTACCAGTGCGAAAC-1	Monocytes
GGATTACAGCGATATA-1	Monocytes
GTCCTCAGTGCCTTGG-1	T cells
TAAGAGAGTTCCGTCT-1	B cells
TAGACCATCAGATAAG-1	Monocytes
CAAGGCCAGCGTTCCG-1	Monocytes
ACTGTCCTCACAGGCC-1	T cells
GATGCTACAGCGTAAG-1	B cells
TCATTTGAGAACAACT-1	T cells
CAGTAACCAAAGGCGT-1	NK cells
CCGGGATTCCCTCTTT-1	T cells
CATCGAAGTAAATGTG-1	T cells
GGGTCTGGTTCCACTC-1	T cells
TTCGGTCGTCGGATCC-1	T cells
GAACGGAGTCGTCTTC-1	mDCs
AAGGTTCCAAGGCTCC-1	B cells
CAACTAGAGTGTGAAT-1	T cells
CATGCCTCAAGCGCTC-1	Monocytes
ATCATGGGTCAATACC-1	T cells
TGACTTTTCGCTAGCG-1	mDCs
GTACGTATCTCGTATT-1	Monocytes
CAGTCCTAGCTAGCCC-1	B cells
CTTTGCGCAAGTCTAC-1	B cells
CCATGTCTCCGCAAGC-1	T cells
GATCTAGAGTGGGATC-1	Monocytes
AGTTGGTGTGCCTTGG-1	T cells
TTATGCTAGTAGTGCG-1	Doublets
CATCAGAGTGACTCAT-1	B cells
CGACCTTGTCAGCTAT-1	NK cells
ATCACGACATCCTTGC-1	T cells
CCGGGATCATGAGCGA-1	T cells
CACACAACAGCTCCGA-1	T cells
ATCGAGTGTTCAGTAC-1	Monocytes
AGGCCGTGTACCATCA-1	T cells
GGACGTCGTAAATACG-1	T cells
CCTCTGACAACTGGCC-1	Monocytes
GTATTCTCAATCCGAT-1	Monocytes
CGTCCATAGCATCATC-1	T cells
GCAAACTGTACAGTTC-1	Monocytes
GGCTCGATCCATGAAC-1	T cells
ACTATCTGTATATCCG-1	Monocytes
TGGACGCTCGGAAATA-1	Monocytes
CTAGCCTGTCAACATC-1	T cells
ATTACTCAGCCACGCT-1	Monocytes
ACACCGGTCCCATTTA-1	T cells
CGACCTTTCATGTGGT-1	Monocytes
GCATACATCGCAAACT-1	Monocytes
AGGCCGTAGCTGGAAC-1	T cells
CGCTGGAGTTGATTGC-1	Monocytes
TGACGGCAGTGTCTCA-1	T cells
GGGTCTGCACTCAGGC-1	T cells
CGATCGGGTTCTGAAC-1	Monocytes
TAGAGCTAGCCAACAG-1	T cells
TCTATTGTCACCCTCA-1	T cells
GACGTTAGTGGTGTAG-1	T cells
CAAGTTGCAAGCGAGT-1	T cells
AGTCTTTGTGTTTGGT-1	Doublets
AACTTTCTCAACACGT-1	Monocytes
GACACGCCACTTCGAA-1	T cells
CACACAAAGCGTAGTG-1	T cells
ACGCCAGAGAGACGAA-1	T cells
ACTATCTAGTTATCGC-1	B cells
TCGCGTTCACGGCTAC-1	T cells
CAGAATCCAATGAAAC-1	B cells
CCGTTCAAGAATCTCC-1	Monocytes
GGTGTTACAATAACGA-1	Monocytes
ACAGCTACATACGCTA-1	NK cells
CTCGAGGTCCCATTAT-1	NK cells
GCAAACTGTATTAGCC-1	Monocytes
TAGACCACAATGGTCT-1	T cells
GCTGCAGAGGATGGAA-1	Monocytes
TGGTTCCGTGCCTTGG-1	T cells
GTAACTGCAGTATAAG-1	Monocytes
CGTGAGCTCGTTTGCC-1	T cells
ACAGCTATCGCATGAT-1	T cells
TGGCTGGAGTCCGTAT-1	T cells
ACGGCCAAGTACGTAA-1	Monocytes
GCGAGAAGTAAACGCG-1	T cells
TCCCGATAGTGGTCCC-1	T cells
GACTGCGAGGCGCTCT-1	T cells
TCTGGAATCACATAGC-1	T cells
AGGTCCGGTGAGGCTA-1	Doublets
AAACCTGAGATAGTCA-1	Monocytes
ACATCAGGTGTGACCC-1	T cells
GCGACCAAGAAGCCCA-1	Monocytes
TGGCCAGGTACAGTGG-1	T cells
ACATGGTCAAATACAG-1	T cells
GTACTTTCATGAAGTA-1	T cells
CGTGTAAGTCACTGGC-1	T cells
GACCTGGCACCGATAT-1	Monocytes
CATCAAGTCGCCAGCA-1	Monocytes
GTAACGTAGAGGTAGA-1	T cells
TCAACGAAGCTAGGCA-1	T cells
GGCTGGTAGAGCTGCA-1	T cells
TGGCGCAGTCGGCTCA-1	T cells
GCGAGAATCTACTCAT-1	T cells
TACAGTGTCGTACCGG-1	T cells
TATGCCCCACTCTGTC-1	T cells
TAGTTGGCACTAGTAC-1	T cells
GCTGCAGGTGCATCTA-1	T cells
CACATAGGTGCGCTTG-1	T cells
GTGCTTCTCCACTGGG-1	B cells
GGCTCGAAGAATTCCC-1	T cells
TGTATTCTCGGAGCAA-1	T cells
TGACAACCATAGTAAG-1	T cells
CGATGGCGTTGAACTC-1	T cells
ATTTCTGCAAGAGTCG-1	T cells
GTATTCTAGGATGGAA-1	T cells
AAGGTTCGTGCCTGCA-1	T cells
TGCCCATAGCCTTGAT-1	B cells
ACGGCCAAGGAGTAGA-1	T cells
CGTCAGGTCAGCATGT-1	B cells
GGCGACTCAATGGACG-1	Monocytes
AACTCCCGTCTCAACA-1	B cells
AGGGTGATCGCCTGTT-1	T cells
TCAACGAAGCTGCCCA-1	B cells
CTGAAGTCATGGAATA-1	T cells
CAAGAAATCGAACGGA-1	Doublets
TAAGCGTCACGTTGGC-1	T cells
TAGAGCTCAGCTCGAC-1	B cells
ACTGTCCCATGTAGTC-1	T cells
CATGCCTAGCATCATC-1	NK cells
TTCTCCTCACAGATTC-1	Monocytes
TACGGATAGGTTCCTA-1	T cells
CCGGGATTCCTTGACC-1	Monocytes
CATCAAGTCTCTGCTG-1	T cells
GCACTCTTCTGAGGGA-1	T cells
AGCATACCAAGCCATT-1	T cells
GAAATGATCGTCCAGG-1	T cells
TCAGGTATCTATGTGG-1	T cells
GGACATTCACAGTCGC-1	B cells
CAGAGAGGTAAACCTC-1	T cells
TGGGAAGTCATCGCTC-1	T cells
TCTCATAAGCGTGTCC-1	T cells
TTGGCAAAGACACTAA-1	B cells
GACTGCGAGCTGCGAA-1	B cells
CACACAATCAATAAGG-1	T cells
TCGGGACCAGGACGTA-1	T cells
CAGCAGCAGGGTGTTG-1	T cells
GCAGCCAGTGTTTGTG-1	Monocytes
GATCGTATCATTATCC-1	Monocytes
GATGAGGAGAAACCGC-1	T cells
GTCAAGTCATCCAACA-1	Monocytes
CAGCTGGCAGCTGCAC-1	Monocytes
AACCATGTCGGAAACG-1	T cells
GACGGCTGTTGTCTTT-1	T cells
TCAATCTTCGGTGTCG-1	B cells
TACTTGTAGTGCCAGA-1	Monocytes
TCAGGTATCACCCTCA-1	T cells
CTCACACCAGTTCATG-1	Monocytes
CACCTTGCAACTGGCC-1	B cells
ATCTGCCAGTGTACCT-1	Monocytes
GCTGGGTAGGTAGCTG-1	T cells
CTAGAGTTCCGCAGTG-1	T cells
CTAAGACCAGGTGGAT-1	Monocytes
TGAGCATAGTACGATA-1	Monocytes
TGACTTTCAAGAGTCG-1	Monocytes
GAACCTAGTATCAGTC-1	T cells
AACCGCGGTAGGAGTC-1	T cells
CGCTTCAGTTTGTTGG-1	T cells
GTGAAGGTCGTCACGG-1	T cells
TGGCGCAAGTTCGATC-1	T cells
TAAGCGTTCGCCGTGA-1	T cells
GCTTGAACACTTCGAA-1	T cells
GATCAGTCATGCTAGT-1	NK cells
CTAACTTCACCTATCC-1	T cells
TCAATCTGTTTGCATG-1	T cells
TCTATTGTCACCATAG-1	Monocytes
CTAACTTTCTAACCGA-1	Monocytes
TTAGGCAGTGTGAAAT-1	T cells
TTCCCAGTCTATCGCC-1	T cells
AAACCTGCATGAAGTA-1	Doublets
GCGCCAAGTCATGCAT-1	mDCs
TCCCGATCATGGATGG-1	mDCs
CGAGCCATCACTCTTA-1	T cells
AGCGTCGAGACCGGAT-1	NK cells
TGTGGTAGTCTAAAGA-1	B cells
CATCGAAAGTCATGCT-1	B cells
TCGGTAATCGTCTGCT-1	T cells
AACCATGTCGGATGTT-1	pDCs
GCGAGAAAGTGTGGCA-1	T cells
AAAGCAAGTCAAGCGA-1	T cells
GAGTCCGGTGTATGGG-1	Monocytes
CATCAAGGTGCGGTAA-1	B cells
TTGACTTAGTTGCAGG-1	T cells
ATCCGAAGTACTCAAC-1	T cells
GACGGCTCAGCTGCAC-1	T cells
GAGGTGACAAGAAGAG-1	T cells
ACCCACTAGGTGATAT-1	Monocytes
TACCTTACAGTGGGAT-1	T cells
GCGCAACGTCGGATCC-1	T cells
CGGTTAACAAGTCTAC-1	NK cells
GATTCAGAGATGGCGT-1	Monocytes
CATCAAGTCCACGTGG-1	T cells
TGACTTTTCGGAGCAA-1	T cells
CGACCTTAGGAGCGTT-1	Doublets
TCTTCGGGTCTCCCTA-1	Monocytes
CATTATCTCAGAGACG-1	Doublets
AAGGAGCGTGGTTTCA-1	Monocytes
ATCTACTTCCCATTTA-1	T cells
CTCGTCAGTAGGGACT-1	Monocytes
GGGACCTCATAACCTG-1	T cells
CGTGTCTAGCAGACTG-1	B cells
CCGTGGACAGTTCATG-1	T cells
TCAGCTCTCTTGCCGT-1	T cells
CTCGGAGGTGCAGTAG-1	Monocytes
GGGACCTCAAATTGCC-1	T cells
GCTTGAACAGCTGTGC-1	T cells
TGTTCCGCACGTCAGC-1	B cells
GGGCACTGTGATGTGG-1	Monocytes
ACGATACCATGCCCGA-1	Monocytes
CTGCCTAGTGAGTGAC-1	Monocytes
GGGACCTAGCGTCAAG-1	T cells
AGAGCGACACTTAACG-1	Monocytes
CACAGTAAGGATCGCA-1	B cells
TAGCCGGGTCTCCACT-1	Monocytes
ACACCCTGTAAGGGCT-1	T cells
AAAGTAGAGCGACGTA-1	T cells
CGTCCATAGTGTACGG-1	B cells
TTTATGCAGCCAGTTT-1	T cells
CTTCTCTGTACCGTTA-1	T cells
TGAAAGACAGATGGGT-1	T cells
GGCTGGTAGTTAGGTA-1	T cells
ACACCGGCACACATGT-1	NK cells
CGTGTAAAGTTGTAGA-1	T cells
CATGCCTTCGCCCTTA-1	Monocytes
GGCTGGTGTTTAGGAA-1	T cells
ACCCACTAGCAATATG-1	B cells
GACCTGGTCGCGTAGC-1	T cells
CAGCTAATCCTTAATC-1	Monocytes
CTAACTTAGCCGGTAA-1	Doublets
AAGACCTAGAATTCCC-1	T cells
TGCCCATGTAGCCTCG-1	T cells
TGCCCTATCAAGGTAA-1	B cells
ACGATACTCGTAGGTT-1	NK cells
ACTGAGTCAACACGCC-1	T cells
CTAGTGAGTCTCTTTA-1	T cells
GTGCAGCCACTTAAGC-1	T cells
GACCTGGCAGCCTATA-1	Monocytes
CCACGGATCAGTTCGA-1	B cells
ATCCACCAGTCACGCC-1	T cells
ATCGAGTCAGGGTATG-1	T cells
TAGACCATCAGCGATT-1	T cells
CGATGGCGTTCCTCCA-1	T cells
CCTACCACACGGTTTA-1	T cells
GACGCGTCAACACCCG-1	T cells
CATATTCAGTCTTGCA-1	Monocytes
GTACTTTGTAACGACG-1	Monocytes
CAAGGCCCACCTTGTC-1	NK cells
CGGACTGTCAAACCGT-1	T cells
CGATCGGGTAGTACCT-1	T cells
CATATGGGTTCAACCA-1	Monocytes
CTACACCAGTGAACGC-1	T cells
GATTCAGTCTTAGAGC-1	T cells
CGTTCTGAGGCTCAGA-1	Monocytes
GATCGCGGTAGGAGTC-1	Monocytes
CCCATACCACTGCCAG-1	T cells
CGGACTGTCGGATGGA-1	Monocytes
TCGCGTTTCAGCATGT-1	T cells
TGACTAGAGTACGCGA-1	Doublets
GTAACGTTCCACGTGG-1	T cells
TGACGGCCAGCGTAAG-1	T cells
CCACTACCACGGACAA-1	T cells
CGTCTACAGAGTGACC-1	T cells
TGCCAAAAGACGACGT-1	T cells
GGACGTCTCTTGAGGT-1	B cells
AAATGCCGTTTCGCTC-1	T cells
TACCTTACAGAAGCAC-1	NK cells
TTATGCTAGGTGCAAC-1	T cells
CTTTGCGAGTTAGCGG-1	T cells
ATAGACCGTCAGGACA-1	T cells
TGGCCAGTCTACTATC-1	Monocytes
CATCGAATCGACAGCC-1	T cells
TGAGCCGCAGTATGCT-1	B cells
TATCAGGGTGGTCCGT-1	Monocytes
TTAGGCATCAGCGACC-1	T cells
AGCTTGATCACTTATC-1	T cells
GATTCAGCAGATGAGC-1	B cells
AAGCCGCGTGTAACGG-1	T cells
GTCATTTAGGCAGTCA-1	Monocytes
GCTGGGTGTTAAAGAC-1	T cells
GTATCTTTCATCATTC-1	T cells
ACGAGCCTCGGAGCAA-1	T cells
TTATGCTCATTTCAGG-1	T cells
ATCGAGTAGCCCAATT-1	T cells
CACAAACGTAGATTAG-1	Monocytes
ACTTGTTAGGGTGTGT-1	T cells
CCTATTAGTAGTGAAT-1	T cells
ACCTTTACACCGTTGG-1	B cells
GCTCTGTCAAGTCTGT-1	T cells
TCGGTAATCTCGCTTG-1	B cells
CAAGATCCAGCTTCGG-1	T cells
TGTATTCCACTCGACG-1	Monocytes
CATCGAACAGTAAGAT-1	T cells
ATTGGACTCTTCAACT-1	Monocytes
CAGAGAGAGTCCATAC-1	NK cells
TCTCTAATCCAGAAGG-1	Monocytes
AGCCTAAGTTTGGGCC-1	Monocytes
TCTCTAAGTATATGGA-1	T cells
AACTCAGTCCAACCAA-1	T cells
CTAAGACAGCGTGAGT-1	T cells
TTGAACGCAGTTCCCT-1	B cells
AAAGTAGAGTCCATAC-1	B cells
CTCGTCAGTTCGAATC-1	mDCs
TCTCTAACAACTTGAC-1	Monocytes
AACTCTTAGATAGGAG-1	T cells
ATTATCCGTCTCTCGT-1	T cells
ACTGAGTGTGAGTGAC-1	B cells
TATCTCATCGACCAGC-1	T cells
AGTCTTTCAGCCAGAA-1	T cells
GCTCTGTTCTTACCTA-1	B cells
CACCACTGTTCAGCGC-1	Monocytes
CTACATTGTCGTTGTA-1	T cells
CGCTTCAAGCTCTCGG-1	Monocytes
ACGGGTCGTTACAGAA-1	Monocytes
GCTCCTACAGCCAGAA-1	B cells
GGCTCGAAGAAGGTGA-1	B cells
AACTGGTGTACGAAAT-1	B cells
GAGCAGAAGGTTCCTA-1	Monocytes
TTCTACATCACCAGGC-1	B cells
GCATGTAGTCAGGACA-1	Monocytes
CATTCGCAGCCGATTT-1	T cells
TCGCGTTAGTTAGCGG-1	T cells
ACGGGCTGTACAGACG-1	Monocytes
TGGCGCAAGCAGGCTA-1	T cells
CACATTTCATCACCCT-1	Monocytes
TACACGAAGTAACCCT-1	B cells
TGGCTGGCATGTCGAT-1	T cells
ACTTGTTTCTTAGAGC-1	T cells
AGGTCCGTCCAAGTAC-1	NK cells
CTTCTCTCACAGAGGT-1	T cells
CTGATAGGTTGACGTT-1	T cells
TTGACTTAGATGGGTC-1	Monocytes
ACGGGTCGTATCACCA-1	T cells
CCACCTACATTGAGCT-1	B cells
GGAATAAGTTTGACTG-1	Monocytes
CACCACTTCTGCAAGT-1	B cells
AGCTTGAAGGTGCTTT-1	T cells
GTTCTCGTCTTGACGA-1	T cells
GCGGGTTAGCTAAGAT-1	T cells
CGCTTCATCAACGGCC-1	B cells
CACCACTTCATCGGAT-1	Doublets
CAACCTCGTAGGCATG-1	T cells
GGACATTCATTGCGGC-1	Monocytes
CTGGTCTCAGCTTCGG-1	T cells
GGTGCGTCATCGGACC-1	T cells
TTCTTAGAGGAGTTGC-1	T cells
GATGAGGGTCGACTAT-1	T cells
GCACTCTAGAGATGAG-1	B cells
AGAATAGCAAGCGAGT-1	Monocytes
AAGGAGCTCTGTGCAA-1	T cells
CTACATTAGCCACGCT-1	T cells
TGCACCTAGCCACGCT-1	B cells
GCCAAATAGTGCTGCC-1	B cells
GGGAGATTCACCATAG-1	Monocytes
CCAATCCGTATTCGTG-1	B cells
GTCTTCGGTCTCTCTG-1	NK cells
GCTGCGAAGCCGTCGT-1	Monocytes
ATTCTACGTCGAGTTT-1	T cells
CCGTACTTCGTTGCCT-1	B cells
CAGCATAAGTTGAGTA-1	T cells
GAACCTATCCATGCTC-1	Monocytes
CGTAGCGAGGGAGTAA-1	T cells
GAGTCCGAGAGAACAG-1	B cells
CATTATCTCTAACTCT-1	T cells
GGTATTGTCAGCTCTC-1	T cells
GCATACACAATACGCT-1	T cells
AGTAGTCGTTCCCGAG-1	Monocytes
GCTCTGTTCATCGGAT-1	NK cells
CTTAGGAAGCCAACAG-1	Doublets
GGAACTTAGCCAGGAT-1	Monocytes
GGCGTGTAGTAGTGCG-1	NK cells
AGATCTGAGTCGAGTG-1	T cells
CTAAGACAGACAGACC-1	T cells
AAAGTAGGTTACTGAC-1	Monocytes
GCAGCCACAAGGTTCT-1	NK cells
GATCGTATCTGAAAGA-1	B cells
CGTCACTCACTTACGA-1	T cells
GCTGCGACAAGCGAGT-1	T cells
CGGTTAATCCGTAGGC-1	T cells
CTCGGGATCCCAAGTA-1	B cells
ACCTTTATCTCTTATG-1	T cells
TACAGTGTCCGCTGTT-1	T cells
ATCACGATCCAAGCCG-1	T cells
GACTACATCGTGGACC-1	T cells
TCATTACCAAGTAATG-1	T cells
TGCCCATGTGTTTGTG-1	T cells
GAAACTCCACAACTGT-1	NK cells
TACTTGTTCGAGGTAG-1	T cells
CAGAATCAGAGACTAT-1	T cells
GGACAAGAGCCATCGC-1	T cells
ACTATCTAGTCTCAAC-1	B cells
AGCAGCCAGATGTCGG-1	mDCs
TACTTACCACTAGTAC-1	T cells
TCTTTCCGTCTGATCA-1	T cells
GACACGCAGATAGTCA-1	B cells
TACACGACATATACGC-1	Monocytes
TAGCCGGGTCCCTTGT-1	T cells
CTGCTGTAGACACGAC-1	Monocytes
CCGTTCAGTTCTGGTA-1	Monocytes
AGCCTAAGTCCGAACC-1	T cells
CCAGCGAAGCTGGAAC-1	T cells
CGTTCTGGTGCACGAA-1	T cells
TTATGCTAGGGAGTAA-1	Monocytes
TCACAAGAGTGTCTCA-1	T cells
GGCTGGTTCCCGGATG-1	Monocytes
CACAAACGTGCTTCTC-1	Doublets
ATAAGAGTCGAATGCT-1	T cells
CATATGGTCAACGCTA-1	Monocytes
TTAGTTCTCCCTAACC-1	B cells
TGGCTGGGTACCATCA-1	T cells
TGATTTCGTAGCGTAG-1	T cells
GTCTTCGGTTTCCACC-1	mDCs
CTGATAGAGGAATGGA-1	Monocytes
ATAAGAGAGGTGCACA-1	NK cells
CAACTAGGTAGCTTGT-1	T cells
TTGGCAATCCACGCAG-1	B cells
CGTGTAAAGAATGTGT-1	T cells
GCGACCACACGAGAGT-1	T cells
AGTGGGAGTACAGACG-1	T cells
GGTGCGTCACGAGAGT-1	T cells
TTCTTAGGTCAAAGCG-1	Monocytes
TATCTCATCATAAAGG-1	Doublets
GTCTCGTTCTACTCAT-1	T cells
CAGCAGCAGAATCTCC-1	B cells
CTTTGCGCACAGGAGT-1	Monocytes
CATCCACAGGCTATCT-1	Monocytes
TGAGAGGAGCAGGCTA-1	NK cells
ATCCGAAGTCTTGATG-1	T cells
AAGGTTCCACACGCTG-1	Monocytes
CTACCCATCAACACGT-1	B cells
TAGAGCTCACGAGAGT-1	mDCs
CGCTTCAAGTGACTCT-1	B cells
CCCAATCGTTACGTCA-1	T cells
GAGTCCGAGGAATTAC-1	NK cells
CTAATGGAGTTGCAGG-1	NK cells
AACGTTGCAGTCGTGC-1	T cells
CATTATCTCAACTCTT-1	mDCs
AGTGGGAGTAGCGTGA-1	Monocytes
ATCACGATCATGTAGC-1	Monocytes
CGGACGTTCAAACAAG-1	pDCs
CAAGAAACAGCTATTG-1	B cells
GCAAACTCATATACCG-1	T cells
AAGACCTGTTTGACAC-1	T cells
CCCAGTTCAAGTAATG-1	B cells
ATCGAGTGTGATGTGG-1	Monocytes
TCAACGAAGCGAGAAA-1	T cells
CATCGAATCGAGAGCA-1	T cells
TAGAGCTGTGGACGAT-1	Monocytes
TACCTATGTCCATGAT-1	Monocytes
CACACCTGTGCCTGGT-1	T cells
ACTTGTTGTCCGAGTC-1	T cells
TACGGATAGAAGGACA-1	T cells
TACAGTGCAGACAAGC-1	Doublets
TCAGGATTCATTGCGA-1	Monocytes
CGTTGGGAGAGCTATA-1	T cells
CAGCCGACATGCGCAC-1	T cells
CAGCCGATCGCTTGTC-1	T cells
AACTGGTGTACATCCA-1	T cells
GAGCAGAAGACCACGA-1	Monocytes
GCAATCATCAGAAATG-1	T cells
GCAGCCATCATCGCTC-1	B cells
TGCTACCTCGAGAACG-1	T cells
TGGTTCCTCCAGAGGA-1	T cells
TACGGATGTCTGGAGA-1	T cells
CCTCTGAGTCCGAAGA-1	T cells
TGAGGGAAGATATACG-1	NK cells
AATCCAGTCTCGCTTG-1	Monocytes
CTACATTAGACTTGAA-1	Monocytes
GCCTCTAAGACAATAC-1	T cells
CGCGGTAGTTGGTAAA-1	T cells
GTTCATTCAGGGTTAG-1	T cells
CATCGGGCAGCTCCGA-1	T cells
TTCGGTCCATTGTGCA-1	mDCs
GTTCGGGCAGTAGAGC-1	T cells
ACACCGGAGGCAGGTT-1	T cells
TATCTCATCCGCAGTG-1	B cells
ACATCAGAGGTGCAAC-1	T cells
CAACCAACATTCACTT-1	B cells
TCGGGACAGCGTGAGT-1	Monocytes
GTCATTTGTTGTGGCC-1	T cells
CATGGCGGTCATGCAT-1	Monocytes
ATCCGAATCGGAATCT-1	T cells
CCCATACAGATGTGGC-1	Monocytes
AACTTTCTCATCGGAT-1	mDCs
GCCAAATGTCGTTGTA-1	T cells
CCAGCGAAGTTGCAGG-1	B cells
ATCCGAATCCTTGCCA-1	T cells
TCTATTGGTGAGTGAC-1	T cells
ATCATGGAGTTGAGAT-1	T cells
ATGAGGGAGAAGGTGA-1	Monocytes
ACGGGCTCACGGTTTA-1	T cells
GATCGTAGTCTAGGTT-1	T cells
CGGACGTCACATCCAA-1	T cells
ACGGGTCTCGCTGATA-1	T cells
CGTGTCTAGTAGCGGT-1	T cells
CTCCTAGTCAAAGACA-1	T cells
TCAATCTGTTCCGTCT-1	T cells
AGTGGGACACTTCTGC-1	T cells
ACTGCTCCAGGGTACA-1	T cells
TTCTTAGAGACGCAAC-1	Doublets
ACTGAGTTCCGGGTGT-1	T cells
CTCAGAAAGGTGTGGT-1	T cells
AGTTGGTGTACCGGCT-1	pDCs
CAACTAGTCAGTTAGC-1	T cells
TGTGTTTCACGGTGTC-1	Monocytes
ATAGACCCAGCTGTTA-1	T cells
GTCTTCGTCGATCCCT-1	T cells
ACATCAGCATATACGC-1	B cells
AAACCTGGTGCGGTAA-1	T cells
CCACCTAAGGCTAGCA-1	B cells
CAGAATCAGATGTGGC-1	T cells
CGACCTTAGTACACCT-1	T cells
GGGCACTCAGCCTTGG-1	T cells
GAACCTATCATCACCC-1	NK cells
TGGGCGTGTGACAAAT-1	T cells
CATCAAGCAACTGCGC-1	T cells
TAGAGCTTCCCAAGAT-1	T cells
AGGCCGTCACATTAGC-1	T cells
CTCGTCAGTGATGATA-1	T cells
AGCTTGAGTGACAAAT-1	T cells
GGGATGACATCGGTTA-1	T cells
TTAGGCAGTCTTCTCG-1	T cells
GTAACTGAGACTACAA-1	T cells
CGATCGGTCATCGCTC-1	T cells
GGGAATGGTTGATTCG-1	Monocytes
CTAGAGTAGGGTTTCT-1	Monocytes
AGGTCCGAGAGGTTGC-1	Monocytes
TGATTTCTCCGTAGTA-1	T cells
GACTGCGTCCCTCAGT-1	B cells
GTACGTATCCCTCTTT-1	T cells
AGCATACCACAGGAGT-1	Monocytes
TATGCCCAGCGGCTTC-1	T cells
CCTACACGTGTTTGGT-1	T cells
GTATTCTGTCCAGTAT-1	T cells
CTGCGGATCTGCAAGT-1	NK cells
GGGCATCCATTGGGCC-1	T cells
ACCGTAAGTTAAGACA-1	T cells
AACTGGTAGCGATAGC-1	Monocytes
AATCCAGGTATAATGG-1	T cells
TAGCCGGGTGCAGACA-1	B cells
ACATCAGTCCTATTCA-1	T cells
GAACCTACATGCTGGC-1	T cells
CCACCTACACCGATAT-1	T cells
TGCGTGGTCCACGAAT-1	T cells
CTGTTTAGTCTCCACT-1	B cells
GTGAAGGCAATAGAGT-1	T cells
CGAATGTAGTACTTGC-1	T cells
CAGCCGATCAATACCG-1	T cells
GCGCGATAGTGTTGAA-1	T cells
CGGACGTAGGAGCGAG-1	T cells
ATTGGACAGCGTTCCG-1	B cells
TTAGGCACAATCGGTT-1	T cells
TGACTAGTCGCCAAAT-1	T cells
CAGCATAAGTACGTTC-1	B cells
ATCCACCAGGAGCGTT-1	B cells
ACACCAAAGGCAAAGA-1	T cells
CCTCTGACAATGAATG-1	T cells
CAGCTGGTCTTCTGGC-1	Monocytes
CGGACACAGTGCGATG-1	T cells
ACGGGCTAGTTCGATC-1	Monocytes
AAAGCAACACCGAAAG-1	T cells
TGGGAAGTCTTCGAGA-1	Monocytes
AGTGGGATCATCACCC-1	T cells
TATCAGGTCCAAACAC-1	T cells
TAGCCGGCAAACTGCT-1	B cells
ACTGCTCTCCTCAATT-1	T cells
GTCTCGTTCAACACGT-1	T cells
CCCAATCCATACGCTA-1	T cells
CTCGTACGTTTGTGTG-1	B cells
GGGATGACAATGTAAG-1	T cells
ATGGGAGTCAACTCTT-1	B cells
GAATGAAAGGGTTTCT-1	T cells
GCAGTTACATGAGCGA-1	Monocytes
CTGAAGTGTCACCCAG-1	NK cells
GCGAGAAGTCATCCCT-1	Monocytes
AGCGTCGAGATCCCAT-1	Monocytes
CCAATCCCATCCCATC-1	B cells
GTAACTGTCCTATTCA-1	Monocytes
CGGCTAGCAGGAACGT-1	NK cells
GCTTCCAAGTCTCGGC-1	pDCs
CTAACTTTCAACACGT-1	T cells
GCACATATCACGCATA-1	T cells
CGCGTTTAGCTAGTCT-1	NK cells
CATTCGCGTTCCACAA-1	T cells
AACTTTCCATAAAGGT-1	T cells
ACCAGTAAGTGATCGG-1	Monocytes
GCATGATAGCGATATA-1	NK cells
AGATCTGAGGATCGCA-1	T cells
TTTCCTCTCCGCGCAA-1	T cells
GATTCAGAGCGTAGTG-1	B cells
ATGTGTGTCTCTGCTG-1	B cells
TTAGGCAGTGTTGGGA-1	T cells
CAACCAAAGTTACGGG-1	NK cells
CAGCGACGTTCTGGTA-1	Monocytes
ACGGGCTCATGATCCA-1	Monocytes
TACTTACGTCCATGAT-1	T cells
ATGTGTGAGCACCGTC-1	mDCs
CGTTGGGTCTGATACG-1	B cells
GTTCTCGAGAAACGCC-1	T cells
CTAGAGTTCGAGAACG-1	T cells
TTCGAAGAGGGTCTCC-1	T cells
GTCCTCAGTAAGTGGC-1	T cells
GGGCACTGTAACGTTC-1	Monocytes
AGTCTTTCAGCTCGAC-1	T cells
GTCATTTAGATGCCTT-1	B cells
ACGGGTCTCCGCTGTT-1	B cells
GGACAAGAGGTACTCT-1	B cells
CGGACACAGGTGCTAG-1	T cells
GATGAAAGTGATGTCT-1	T cells
CAAGTTGGTCAGATAA-1	T cells
AGCCTAACATCCTTGC-1	Monocytes
CATGACATCAACGAAA-1	T cells
AAACCTGCAGGATTGG-1	pDCs
CACACCTTCGGTCTAA-1	T cells
CCCAATCCATGCGCAC-1	T cells
TGGTTAGCAGCCTTGG-1	T cells
GGTGAAGCAGTAACGG-1	T cells
CAAGAAATCCAGAAGG-1	T cells
CTGATCCAGGCAGGTT-1	T cells
CTTCTCTCAAAGGCGT-1	Monocytes
TGGGAAGTCAACACAC-1	T cells
CTACATTCAGATCGGA-1	T cells
CTAAGACTCCACTCCA-1	B cells
GTCATTTAGGGAAACA-1	B cells
AGCTTGACAGGGTTAG-1	T cells
GCTCTGTGTAGCGCAA-1	T cells
CCCATACGTTGAACTC-1	Monocytes
AAATGCCAGGGCTTCC-1	Monocytes
ACCTTTACAATTGCTG-1	T cells
GTCTCGTCAAACGCGA-1	T cells
CCTTTCTTCATTGCCC-1	T cells
CTACATTAGAGACGAA-1	T cells
TACTTGTCATATACCG-1	mDCs
GTTCATTTCGCCATAA-1	Monocytes
GCTGGGTCAGCTGTGC-1	T cells
AGGCCGTAGAACTGTA-1	T cells
CTAACTTCAGGCTGAA-1	Monocytes
CACAGTATCTCTTGAT-1	T cells
ATCTACTTCTGGTTCC-1	NK cells
ACACCGGTCGTAGGAG-1	T cells
GATGAGGAGGGCACTA-1	T cells
CAGTCCTCACGAAGCA-1	Monocytes
ACGAGGACAAAGGAAG-1	NK cells
TTGGCAAAGCAGGCTA-1	B cells
TGGTTCCGTTCCATGA-1	Monocytes
GTTACAGTCCGGCACA-1	T cells
CGCGTTTCAAAGAATC-1	T cells
TTATGCTGTCTAGGTT-1	T cells
GGCGTGTGTAGATTAG-1	T cells
GAAGCAGGTAAATACG-1	T cells
GTACGTAGTGTAAGTA-1	Monocytes
TGAAAGAAGTGAAGAG-1	T cells
CAGCTAAAGCGCCTTG-1	T cells
GGCTCGAGTAGCACGA-1	T cells
GAGTCCGGTAAAGTCA-1	T cells
GCTTCCATCCTACAGA-1	B cells
CTCTACGGTAAAGTCA-1	Monocytes
TCAACGACACTTGGAT-1	T cells
ACTTTCAAGTGCGATG-1	T cells
CGCCAAGGTCTACCTC-1	T cells
GGTGAAGGTTGCGCAC-1	T cells
ACCAGTATCGCCTGAG-1	T cells
TCTCTAAAGCACCGCT-1	T cells
AGTTGGTTCCTAGAAC-1	T cells
CGTGAGCAGTAGATGT-1	B cells
GCAGTTACATTGGGCC-1	T cells
CAGATCATCTGATTCT-1	T cells
ACTGCTCAGTATCGAA-1	T cells
AGCAGCCTCAATCACG-1	Monocytes
ATGGGAGGTAAACCTC-1	T cells
GCTGGGTCAGGAATGC-1	T cells
TGTGGTAGTCAGGACA-1	T cells
ATTGGACAGTACGTAA-1	Monocytes
ATCCACCCAGGGTTAG-1	B cells
GATCGTATCGCACTCT-1	Doublets
ACATACGTCGGGAGTA-1	T cells
CACACAAGTACATGTC-1	T cells
GCTCTGTTCACGAAGG-1	Monocytes
TGAGAGGAGTTAAGTG-1	T cells
TGCTGCTCAGTCGATT-1	Monocytes
GTGCTTCTCTTAGCCC-1	B cells
AACTCCCGTAGAGGAA-1	NK cells
TAAGAGAGTCTCGTTC-1	T cells
TGACTTTGTCTCTCGT-1	T cells
GCGCAACGTGTCAATC-1	Monocytes
CACAGTAGTATCACCA-1	T cells
AGATTGCAGCAATCTC-1	T cells
AGTGAGGAGCCACTAT-1	Monocytes
CTACACCGTTACGCGC-1	Monocytes
CTGCCTAGTTAGAACA-1	Monocytes
TGTTCCGGTCTTTCAT-1	T cells
ACACCGGCATCCTTGC-1	T cells
GATCAGTGTGCCTGGT-1	NK cells
GCGCAGTGTCTGCGGT-1	T cells
GTTAAGCTCAATCACG-1	T cells
TACTTGTGTAGCTTGT-1	Monocytes
CCAGCGAGTTCGTCTC-1	T cells
TGCACCTCATAGTAAG-1	Monocytes
TGCCCATGTACAGTGG-1	Monocytes
GTCAAGTTCTAACTTC-1	T cells
CTTGGCTGTCCAGTTA-1	T cells
GTCACAACACATGACT-1	NK cells
CGATCGGTCATGTCCC-1	Monocytes
GATTCAGAGGTGATTA-1	T cells
CAACTAGAGGTGCAAC-1	T cells
ATCATCTCAGTACACT-1	T cells
CCCTCCTGTCCGACGT-1	Monocytes
CAGAGAGGTGAGGGAG-1	B cells
GTCACGGAGGGAGTAA-1	T cells
GTCCTCAGTACGCACC-1	T cells
ATGTGTGAGAGTCTGG-1	B cells
AATCCAGTCCGAATGT-1	T cells
AAGTCTGCAAGGGTCA-1	Monocytes
ACTGTCCCAGCCTGTG-1	Monocytes
GAGTCCGCATTTGCTT-1	Monocytes
GGGCACTAGATCCCAT-1	T cells
ACTGAACCAGGCAGTA-1	T cells
CGGACACGTAATCGTC-1	mDCs
ACACTGACACAGGTTT-1	Monocytes
GTTCGGGCATCGATTG-1	T cells
AGCGGTCCAATGTTGC-1	Monocytes
TACCTTATCACCACCT-1	B cells
TCTTCGGAGTGAACAT-1	T cells
TGCCCTATCCACTCCA-1	T cells
TACGGTATCGCTGATA-1	Monocytes
CGTGTCTAGGGTCGAT-1	Monocytes
CAGCATAAGTCAAGGC-1	T cells
GCAAACTTCAGCATGT-1	B cells
TCTGAGATCCACGTTC-1	Monocytes
GTCTCGTGTTTCGCTC-1	T cells
CACACCTAGTGAACGC-1	mDCs
AACTCCCGTATTCTCT-1	T cells
CATGGCGGTAGCGATG-1	Monocytes
CAAGAAACACAGTCGC-1	pDCs
CTCTACGGTATAGTAG-1	B cells
CCTTCCCAGATTACCC-1	T cells
GACCAATGTGGCTCCA-1	T cells
CATCCACAGACTAGGC-1	mDCs
CGGAGTCGTTGATTCG-1	B cells
GTAACGTAGAATGTGT-1	T cells
TTAGGACTCGTGACAT-1	T cells
TACCTATAGTTAACGA-1	Monocytes
ACTGATGAGGTAAACT-1	Monocytes
ACAGCTAAGATAGCAT-1	B cells
CGTTAGAGTCTAGAGG-1	B cells
ACCCACTGTAAGTAGT-1	T cells
GTCTTCGCACATCTTT-1	B cells
AGGCCGTTCGGCATCG-1	T cells
CCTACCAAGACGCAAC-1	NK cells
TTGGCAACATACAGCT-1	B cells
GTCGGGTGTTCCACAA-1	T cells
AAAGTAGCACATGACT-1	B cells
TTGACTTAGCCGCCTA-1	T cells
CCTACACTCTGGGCCA-1	T cells
CATATGGCACAGGAGT-1	T cells
CTGATAGCACGACGAA-1	B cells
ATCGAGTGTTTAAGCC-1	T cells
TCGTAGATCTTCATGT-1	B cells
CGAGAAGAGTTGAGTA-1	Monocytes
TTCTCCTCACGTGAGA-1	Monocytes
GGCCGATAGTCGATAA-1	T cells
TACGGATTCTCTGTCG-1	T cells
CACAAACTCGGTGTTA-1	T cells
CCTTCGAAGTGCAAGC-1	T cells
CTTTGCGGTGGACGAT-1	T cells
AAGTCTGAGAGTACAT-1	T cells
TGCTGCTGTTTGTGTG-1	Monocytes
ACAGCCGGTCTCAACA-1	T cells
ACGATGTGTCATCGGC-1	Monocytes
ACATGGTCAACCGCCA-1	T cells
CGATTGACATGCATGT-1	T cells
CCCATACAGCGATCCC-1	T cells
CGTTAGAGTTCAGGCC-1	B cells
AGCGGTCCATGTTGAC-1	T cells
GGGCACTCACATGTGT-1	Monocytes
CATTATCTCTCGATGA-1	Monocytes
ACGAGCCCATGAACCT-1	T cells
ATAAGAGGTTCACCTC-1	mDCs
TATCTCAAGGATGTAT-1	T cells
CTAAGACAGGAACTGC-1	T cells
CTTACCGGTTTGCATG-1	Monocytes
GTCACAACACCACGTG-1	Doublets
GCTTGAAGTCGGATCC-1	Doublets
GCATGTAGTAGCCTCG-1	T cells
ATAAGAGTCGCCATAA-1	T cells
GCTTCCAAGAGCTGGT-1	Doublets
GACGCGTTCCAAGCCG-1	T cells
ACTTTCAGTCGCTTCT-1	B cells
GTACTCCAGAGATGAG-1	T cells
CAGCGACGTGTGAAAT-1	T cells
CACAGTAGTCTGGTCG-1	B cells
CAAGGCCGTCGCATAT-1	T cells
CCACCTATCTGTCTAT-1	mDCs
CGCCAAGGTCGGGTCT-1	T cells
GATGCTACAGATGGGT-1	B cells
GGAACTTTCACTTCAT-1	T cells
CAGTAACAGGCCATAG-1	T cells
GTATTCTTCTTGCAAG-1	Monocytes
GTCACAAAGTGGTAGC-1	Monocytes
AAGCCGCCAATCTGCA-1	T cells
AAACCTGCATCCCATC-1	B cells
GCTGCGAAGGCTAGGT-1	T cells
GTCACAATCGGAAACG-1	T cells
AACGTTGAGGTCATCT-1	Monocytes
CTACACCAGTCTCAAC-1	Monocytes
CACATTTTCCGTTGCT-1	T cells
CCATTCGGTTCTGGTA-1	B cells
CGTAGGCCAAAGGAAG-1	Monocytes
GTAGTCAAGAAGCCCA-1	Monocytes
TATTACCAGTGAACAT-1	T cells
ACGCAGCCACCTTGTC-1	Monocytes
CGTTAGAAGTCAAGGC-1	Monocytes
ACTGTCCCACGAGGTA-1	Monocytes
CAGCATATCATTGCGA-1	B cells
AAACCTGTCTCTGCTG-1	T cells
GGGATGACAGTCGTGC-1	Monocytes
GCATGATCAAAGCGGT-1	T cells
CCTTCCCTCTTCCTTC-1	mDCs
AGTGTCAGTGCAGTAG-1	T cells
CACACTCCAATACGCT-1	B cells
TCATTTGTCCATGAGT-1	T cells
AACGTTGCATGCAATC-1	Monocytes
TCTATTGCAGCCTTTC-1	T cells
TGACAACTCTCGTTTA-1	Monocytes
ATTTCTGTCACCTTAT-1	B cells
TTCCCAGTCACATGCA-1	Monocytes
TTCCCAGAGCCAGAAC-1	T cells
GTCACAAAGTGTTAGA-1	T cells
AACACGTGTACCGTAT-1	T cells
GTGTTAGAGAATGTTG-1	pDCs
CGTTAGAGTAATAGCA-1	T cells
CTAATGGGTGTGTGCC-1	T cells
GGCCGATCACCTTGTC-1	T cells
TAGGCATGTGATGCCC-1	Doublets
CGAGCACTCACAGTAC-1	Monocytes
TTTATGCGTCTGGAGA-1	Monocytes
TGTTCCGTCCCTTGTG-1	T cells
GTGAAGGTCCACGTGG-1	Monocytes
ACTGCTCGTCTGATTG-1	Monocytes
TTAGGCACAACGATGG-1	Monocytes
CACCAGGTCAAGAAGT-1	T cells
AGTAGTCTCATTTGGG-1	NK cells
CTCCTAGTCTGCTGTC-1	T cells
GCGCAACCAAGGTTTC-1	T cells
TGGGCGTTCCTCAACC-1	T cells
CTCATTAAGGATCGCA-1	Monocytes
CATTATCTCGACCAGC-1	T cells
TCTCATATCAGCTCTC-1	T cells
ACGGCCATCTTGTACT-1	T cells
CAGGTGCGTCGACTAT-1	T cells
AACACGTCATGGTTGT-1	T cells
AGATCTGCATCAGTAC-1	T cells
TATCAGGGTTGGTAAA-1	T cells
GAACATCTCCAAAGTC-1	T cells
GGCAATTAGAATCTCC-1	Monocytes
TGCCCATAGGGTCTCC-1	T cells
CGTGTAAAGCTAGTCT-1	B cells
GACCAATTCTTTACGT-1	T cells
CATCAGAGTTGCCTCT-1	B cells
GTACGTATCTTCATGT-1	T cells
CAGCAGCAGATGCGAC-1	T cells
CACTCCATCTGAAAGA-1	Doublets
CGAACATCACAGACAG-1	T cells
AGTAGTCTCGTAGATC-1	Monocytes
CGCGTTTAGCCCAACC-1	Monocytes
CAAGTTGCATACTCTT-1	T cells
AGCATACAGAAGAAGC-1	T cells
GAAACTCAGGTGCTAG-1	mDCs
CGTCACTCAATGGAAT-1	T cells
CCCTCCTTCAGTGCAT-1	T cells
GCTGGGTTCTTGTTTG-1	T cells
TTGCCGTCAGATCGGA-1	T cells
TTAGTTCCACGTCTCT-1	T cells
GACGGCTGTTCGTGAT-1	T cells
TGGCCAGAGGGATACC-1	Monocytes
ATCGAGTCAACAACCT-1	Monocytes
GAAACTCTCACATAGC-1	Monocytes
GGGATGACAGTAGAGC-1	T cells
GCGCAGTCATTGTGCA-1	Monocytes
CGCGGTAGTCTCTCTG-1	Monocytes
ATAACGCGTTCGAATC-1	Monocytes
ATCGAGTCATCCTAGA-1	Monocytes
CGGACTGAGATGTGTA-1	T cells
TTTGGTTCATGCCTAA-1	T cells
ATCATGGAGGCCCTCA-1	T cells
GCCTCTAAGGGAACGG-1	Monocytes
GGTGAAGAGTCCATAC-1	T cells
TTCTCAAAGTACGTAA-1	mDCs
ACTGAGTGTTGATTGC-1	T cells
AAATGCCGTGCAGTAG-1	T cells
CGGAGTCCATCTCCCA-1	B cells
TCTTTCCAGCTAGTTC-1	T cells
AAACGGGTCTGGGCCA-1	T cells
AATCCAGAGCCACCTG-1	B cells
CAGCGACGTTGTACAC-1	B cells
TCAGCTCGTCGCTTTC-1	T cells
CACATAGAGACACTAA-1	T cells
CATGCCTCAGACAAAT-1	mDCs
CAGCTAACAAACTGTC-1	T cells
GCTCCTATCTGGTGTA-1	T cells
TAAGCGTTCACTTATC-1	T cells
CCCAGTTAGATATACG-1	Monocytes
GCAGCCAGTTTAGGAA-1	T cells
TCACAAGCACCTCGTT-1	Monocytes
CTCGGGAAGAAGAAGC-1	T cells
CGCTATCCACGTGAGA-1	T cells
TGGTTAGTCTATCCTA-1	T cells
CGCGGTAGTAAGAGGA-1	T cells
TGTATTCCAGTTAACC-1	Monocytes
GTAACGTCAATGTAAG-1	Monocytes
AGCAGCCTCAGAGCTT-1	T cells
TGACAACAGCGCCTCA-1	T cells
ACGCAGCCATAAAGGT-1	mDCs
TGCGGGTCACTTAACG-1	T cells
GTGCATAAGCTAAGAT-1	T cells
GGGAGATGTGCTTCTC-1	Monocytes
GCTTCCAGTCTGCAAT-1	Monocytes
AGGTCATCAATGGAAT-1	T cells
GTCGTAAGTTTGGGCC-1	Monocytes
CCTTACGTCAGGCCCA-1	T cells
ACTGATGGTCAGCTAT-1	T cells
CATCGAATCCCACTTG-1	B cells
CAGAATCTCTCTGAGA-1	B cells
CGATCGGAGGTGGGTT-1	mDCs
CAGCTAAGTGCTAGCC-1	B cells
CGATTGACAAGAGGCT-1	T cells
TGGCCAGCATTCGACA-1	T cells
TACTTACTCAAAGTAG-1	mDCs
TGCTGCTAGGCGCTCT-1	T cells
CACATTTCAGCTTAAC-1	T cells
GCAATCACACCCAGTG-1	T cells
TGCTACCTCTGCGGCA-1	Monocytes
TGGCCAGGTGGCTCCA-1	T cells
ATAGACCTCAATCACG-1	T cells
GCGGGTTTCCAAGTAC-1	Monocytes
GACCAATTCAGTTGAC-1	Monocytes
AGAGCTTGTTGAGTTC-1	B cells
TTGAACGGTTCATGGT-1	T cells
TTTCCTCCAAATACAG-1	Monocytes
ACCGTAATCACATACG-1	pDCs
CCTTCCCAGGCTACGA-1	T cells
ATTACTCGTACTCAAC-1	B cells
CTGATCCGTCTCATCC-1	T cells
GTTACAGGTCTCTTAT-1	Monocytes
TGGCCAGTCTAACTGG-1	T cells
AGCCTAATCATTCACT-1	mDCs
CACATTTTCAAGGCTT-1	T cells
GTACTTTGTCGCTTCT-1	Monocytes
CCTCTGAGTGGGTATG-1	Monocytes
AACCATGGTATCTGCA-1	T cells
AAGGAGCGTCAAAGCG-1	T cells
CTACCCATCTACTTAC-1	Monocytes
TCGAGGCAGGATGTAT-1	Monocytes
CTAAGACAGATGAGAG-1	T cells
CTACACCAGTGGTCCC-1	T cells
GTGAAGGGTGATGTGG-1	T cells
TTGACTTTCAGGCGAA-1	NK cells
CGACCTTGTAGTAGTA-1	Doublets
GACTACAGTCCTGCTT-1	NK cells
ACGATACAGAATGTTG-1	Monocytes
CATGGCGCAGTAGAGC-1	B cells
GGTGTTACACTGAAGG-1	T cells
ACTGAACTCTGGCGTG-1	Monocytes
TACTTACGTAGTGAAT-1	T cells
CTGCTGTAGAGCTGGT-1	T cells
GGGAATGGTACCCAAT-1	B cells
CGAATGTCATACAGCT-1	NK cells
TCGTAGAGTTCCACTC-1	Monocytes
ACTTGTTCAACTGGCC-1	B cells
GGACGTCCATGAACCT-1	T cells
GGAGCAATCGTCACGG-1	B cells
AAACGGGGTGGACGAT-1	T cells
TACCTTATCGATCCCT-1	T cells
CTTAGGAGTTCGCGAC-1	T cells
AGCTCTCTCACATACG-1	T cells
CGTTCTGCACATTCGA-1	Monocytes
ATAACGCGTAAGTTCC-1	Monocytes
AAATGCCAGACGCACA-1	T cells
GCGCGATCACATCTTT-1	T cells
CGTTCTGCACAGGCCT-1	T cells
TTTACTGGTTATCGGT-1	B cells
GGGAATGTCTACCTGC-1	T cells
CCGGGATCAAGTAATG-1	Monocytes
TCGAGGCGTCTACCTC-1	mDCs
GTAGGCCCACAGGTTT-1	T cells
CGGACACGTCTAACGT-1	T cells
GCTTCCATCTCCTATA-1	T cells
GTTTCTAGTAAGTAGT-1	T cells
CGAATGTCATCACCCT-1	Monocytes
TAGTGGTCATGGTAGG-1	T cells
GGGTTGCAGCCAGGAT-1	B cells
CACACAAAGTGAATTG-1	Monocytes
CAGCGACGTGTGCCTG-1	Monocytes
CAGTCCTAGAATTCCC-1	T cells
CAAGGCCAGACGACGT-1	T cells
GCATGCGCAGACGCTC-1	T cells
CGAACATCACTCAGGC-1	B cells
GAACATCTCTGGTGTA-1	T cells
CATATGGAGTACCGGA-1	B cells
CGTGAGCAGCTGTCTA-1	T cells
AACTTTCAGAGTAAGG-1	T cells
TTCCCAGTCCTAGTGA-1	Monocytes
CACACCTAGATCTGAA-1	T cells
GTCACGGAGCGAAGGG-1	B cells
CAGTCCTTCTCACATT-1	T cells
CACATTTTCCACGTGG-1	T cells
CGTTCTGAGAAACGCC-1	Monocytes
CCTACACAGAGTACCG-1	Monocytes
GGACATTCATGAAGTA-1	T cells
TGGACGCAGTACACCT-1	Monocytes
CTCATTAAGGTCATCT-1	Monocytes
CGTAGGCAGCTGATAA-1	Monocytes
GTGCAGCGTGACGGTA-1	T cells
CATCCACCAAGGACAC-1	T cells
CTCTAATGTTAGTGGG-1	T cells
GTATTCTGTAGGCTGA-1	T cells
TCGAGGCGTGTGAAAT-1	T cells
TTGCGTCCACTTCTGC-1	T cells
GGTATTGGTGAGGCTA-1	Monocytes
CATATGGCACAACGCC-1	T cells
GCATACAGTTTAAGCC-1	T cells
TTAACTCAGCTAACAA-1	mDCs
AGTTGGTTCGCGATCG-1	Monocytes
TATTACCAGTCATGCT-1	T cells
CAAGTTGTCCGCGTTT-1	Monocytes
GGATGTTCAGATCGGA-1	B cells
TCATTACGTCACCCAG-1	T cells
TTTGGTTCAGGACGTA-1	T cells
CTTAGGATCACCGTAA-1	T cells
CGTCAGGAGAGACTAT-1	T cells
CCGTACTTCATACGGT-1	Monocytes
CGATGTATCGGATGGA-1	Monocytes
GCATACATCGTACGGC-1	T cells
ACGATGTAGAGACTAT-1	Monocytes
CTGGTCTCAGGCAGTA-1	Monocytes
CCTACACAGGTGACCA-1	T cells
ATCTACTTCTATCCCG-1	T cells
CTGCTGTGTCGCGAAA-1	T cells
GAACATCAGTTAGCGG-1	T cells
TGGACGCAGTGACATA-1	T cells
ATCTGCCGTACTTGAC-1	B cells
ACTGTCCCATTCCTGC-1	T cells
GATGAAAGTTCATGGT-1	T cells
TGAGAGGTCATTTGGG-1	Monocytes
GCAATCACAGATAATG-1	T cells
GCGCAACCAACGATCT-1	T cells
CAGAATCCATTAGGCT-1	T cells
ATCATGGCAATGAATG-1	T cells
TAGACCACACATAACC-1	T cells
AGGCCACGTTCGTCTC-1	B cells
GTTAAGCAGTGAAGAG-1	Monocytes
TGCGTGGTCACCAGGC-1	NK cells
TGACAACAGCCAGAAC-1	Monocytes
TACTTACTCGCGCCAA-1	pDCs
AAGACCTGTGAGGCTA-1	T cells
GCACTCTAGTGCCAGA-1	Monocytes
GCTTGAAGTTCCTCCA-1	B cells
ACAGCCGGTCATACTG-1	T cells
ACGAGGACATTCGACA-1	T cells
GCATGATGTTACGCGC-1	T cells
GCTGGGTTCCATGAAC-1	Monocytes
ATAGACCGTGCACCAC-1	Monocytes
CAAGAAATCTCTAAGG-1	Monocytes
ACTGAACTCGTTTGCC-1	T cells
CATCCACCAAGTTCTG-1	Monocytes
TGTGGTAGTATTCGTG-1	Monocytes
TGTGTTTTCGCCTGTT-1	Monocytes
ATGTGTGCATGCAACT-1	B cells
AAAGTAGGTAAGGGAA-1	Monocytes
GCACATAAGCTCCCAG-1	Monocytes
TGATTTCGTAACGTTC-1	T cells
CTCTAATAGCTGGAAC-1	T cells
TTCCCAGCAAAGTGCG-1	T cells
ACATCAGCAGCTGTAT-1	T cells
GTACGTAAGTACTTGC-1	T cells
ACTTGTTTCATGTCTT-1	T cells
ACTGCTCCAATGAATG-1	NK cells
AGAATAGGTGACCAAG-1	T cells
TAGAGCTGTACTTCTT-1	Doublets
CATCGGGCAGACAAAT-1	T cells
ATGAGGGTCCCAAGTA-1	T cells
ACATACGTCACCGGGT-1	Monocytes
ACACCGGAGTAACCCT-1	Monocytes
TATTACCCAGCTGCTG-1	T cells
GAAGCAGGTAGAAAGG-1	B cells
TTGCCGTAGTAACCCT-1	Monocytes
CTCATTATCTTAACCT-1	Monocytes
ACCAGTAGTCTCTCTG-1	T cells
AGTGAGGCATAGACTC-1	T cells
ACTTGTTTCCCGACTT-1	Monocytes
ATCATCTAGGATGGTC-1	Monocytes
GGCTGGTAGCGTCAAG-1	Monocytes
GGCAATTTCTCACATT-1	T cells
GGTGAAGAGTCTTGCA-1	B cells
CGAGCCAGTACATCCA-1	Doublets
ATCATCTGTGACTACT-1	T cells
ATCCACCAGCAGACTG-1	Monocytes
GGGAGATAGATCTGCT-1	Monocytes
ACATGGTCATCGTCGG-1	B cells
CGTAGCGTCTTGCATT-1	T cells
TCTATTGAGCGTTTAC-1	Monocytes
TGCCCTACATCCTTGC-1	Monocytes
GGATGTTGTCCAAGTT-1	T cells
TGTGTTTCACACAGAG-1	Monocytes
TACAGTGCATACTCTT-1	Monocytes
TGCGTGGGTACAGCAG-1	T cells
CTCGAAATCAGTGCAT-1	T cells
AAGGCAGCACCATCCT-1	mDCs
GGACATTGTGGCGAAT-1	Monocytes
GAGGTGAAGAAACCGC-1	Monocytes
TTTATGCCACCAGGTC-1	T cells
TGAGAGGCAGGATTGG-1	Monocytes
GGACAGAGTATAGGTA-1	T cells
TAGCCGGGTGCAGGTA-1	T cells
TGCCAAACATTCCTGC-1	Monocytes
CCTCAGTAGAACTCGG-1	Monocytes
GTCTTCGTCAACGGCC-1	Monocytes
ACCCACTTCTACTATC-1	B cells
CGGGTCAGTTACGACT-1	T cells
GGAAAGCTCGAATGCT-1	B cells
TCGCGAGGTGCAACGA-1	T cells
CTACACCGTACGCTGC-1	T cells
ATCATGGAGGCAATTA-1	T cells
TCCACACAGGGAGTAA-1	T cells
CGGACGTAGGGTATCG-1	T cells
GAGCAGAGTCTCATCC-1	B cells
GTTCATTCATCTCCCA-1	T cells
CCTAAAGTCTCTAAGG-1	B cells
CGCTATCGTTCGTCTC-1	T cells
CCTAAAGTCGTGGACC-1	T cells
CAGATCATCACGCATA-1	T cells
ATGAGGGTCAAACCGT-1	T cells
CAACCAACACAGACAG-1	Monocytes
TGCTGCTCATGACGGA-1	T cells
TCACAAGGTCTTGTCC-1	T cells
CAGCATATCCCTGACT-1	B cells
TACTTGTCACCGTTGG-1	T cells
TCCACACGTGTCTGAT-1	B cells
TTCTCAAGTGGCTCCA-1	T cells
GACTACACAACGATGG-1	mDCs
GGGAATGTCTATCCCG-1	Monocytes
AACCGCGGTTACGCGC-1	T cells
CCACTACGTCAATGTC-1	B cells
ACAGCTAGTCGGGTCT-1	Monocytes
AATCCAGCAGCCTGTG-1	Doublets
GAAATGAAGACAGACC-1	T cells
AGTCTTTCAAGCTGGA-1	T cells
TCACAAGGTAGCTCCG-1	T cells
GCATGTAAGTTACGGG-1	T cells
TGCTACCAGGCAGGTT-1	B cells
GTGTGCGTCGAGAGCA-1	T cells
TACTTGTAGCCCGAAA-1	T cells
ACTATCTTCACAGGCC-1	Monocytes
GACTAACAGCTCCTCT-1	Monocytes
TCGTACCAGCTAAACA-1	B cells
GATCTAGCAGGCAGTA-1	mDCs
CCTTTCTCAAAGAATC-1	T cells
TGTGTTTTCTGCAGTA-1	T cells
TGGCTGGGTGGTCCGT-1	T cells
AACTCCCGTACCGTAT-1	Monocytes
CTCTAATGTTGGACCC-1	T cells
CAGCTGGCAGTCGATT-1	T cells
CACAAACTCCGCATAA-1	T cells
TGACTTTAGAAGGACA-1	Monocytes
TATTACCCATTGGCGC-1	T cells
ACTTGTTTCGAACTGT-1	Monocytes
CGCCAAGTCATGCATG-1	Monocytes
GGATTACTCCCTAATT-1	T cells
CGAGCCACAAGTCTAC-1	T cells
CGGGTCAAGCCACGCT-1	Monocytes
GCTGCTTCAGGGAGAG-1	T cells
AGCTCCTGTATAAACG-1	B cells
GTTCGGGTCTTGAGAC-1	Monocytes
CTAAGACCACAGCCCA-1	T cells
CATGACATCGAGAGCA-1	T cells
TTTGTCACACTTAACG-1	T cells
TTGCGTCAGCTAAACA-1	Monocytes
ACCCACTAGTGGACGT-1	B cells
TATCAGGTCATGCTCC-1	T cells
TGAGCATAGCGTCAAG-1	B cells
CGGCTAGGTCTCACCT-1	NK cells
GGCTGGTTCCCTCTTT-1	T cells
TGATTTCAGGGCTTCC-1	T cells
ACCCACTTCTGTACGA-1	T cells
CTTAACTGTGTTGGGA-1	NK cells
CATCGGGCACATGGGA-1	B cells
GGCTGGTCATTCACTT-1	Monocytes
GGAGCAAGTGGACGAT-1	T cells
TTTCCTCTCCGAACGC-1	NK cells
TCTTCGGAGTTTCCTT-1	T cells
TCACGAAAGGTGATTA-1	NK cells
CCTCTGACAGATCGGA-1	T cells
GAATGAACAACTGCGC-1	T cells
CGCGTTTTCCTCATTA-1	T cells
CACATAGTCATGTGGT-1	Doublets
ATGGGAGCAGTACACT-1	T cells
AGCTCTCCAATGTAAG-1	T cells
TCTTCGGTCACAGGCC-1	NK cells
TAGGCATGTTCCGTCT-1	T cells
TTCTCAAAGCTCCTCT-1	Monocytes
TCGCGTTGTGTGACCC-1	T cells
GACTAACAGCTGTCTA-1	T cells
AGCATACTCTTGCAAG-1	mDCs
GCATACATCCCATTAT-1	T cells
ACAGCTAGTAAGTGGC-1	T cells
GCGGGTTGTCTTCTCG-1	Monocytes
CTAAGACGTAAAGTCA-1	B cells
TTGCCGTTCATCGCTC-1	B cells
GCATGTATCAGAAATG-1	T cells
GCGCAACAGCGTGTCC-1	T cells
GTGTTAGAGTCAAGGC-1	T cells
TCTATTGCAGCCACCA-1	T cells
GACGTGCGTAGCAAAT-1	mDCs
TTTCCTCAGTTAGGTA-1	T cells
CCTAGCTTCTTCAACT-1	T cells
TGTGGTAGTACCGCTG-1	B cells
CGTAGCGCAAAGTCAA-1	Monocytes
TGATTTCGTCCGTCAG-1	T cells
CTACCCAGTCCTCCAT-1	T cells
GAGCAGATCGCCATAA-1	NK cells
GACGGCTGTTAGATGA-1	T cells
TCAGCTCTCTGCTTGC-1	Monocytes
CAACTAGGTTAAAGTG-1	T cells
CTCGAGGCAAAGTGCG-1	T cells
GCGCAGTAGCGTGTCC-1	Doublets
GACGTTAGTACAGTTC-1	T cells
AACTCCCCACATGGGA-1	T cells
GCGCAACTCACGAAGG-1	T cells
CTCACACTCGCCTGTT-1	T cells
CCGGGATCACCCATTC-1	B cells
TCTTTCCTCGCGCCAA-1	NK cells
ATTGGACCATCGGGTC-1	Monocytes
CGTGTAAGTAGGCTGA-1	B cells
CATATGGAGCGCCTCA-1	T cells
CGAGCCATCTGCAAGT-1	T cells
GGGTTGCAGGTCGGAT-1	B cells
CTGAAGTAGACTACAA-1	T cells
CCCAGTTAGATGCGAC-1	Monocytes
ACTTGTTCACCGGAAA-1	Monocytes
CCCAATCTCGCCGTGA-1	B cells
GGTGAAGGTGTTGGGA-1	T cells
CAGCGACCAAGCGAGT-1	Monocytes
TAAACCGGTCTCACCT-1	T cells
CTCGTACCACATGTGT-1	NK cells
CAGCAGCCATAACCTG-1	T cells
TTATGCTAGCAACGGT-1	Monocytes
TGACAACTCGTAGATC-1	NK cells
CAGTAACTCAACACTG-1	T cells
TCGAGGCCACACCGCA-1	Monocytes
GGCCGATGTGGCGAAT-1	NK cells
GGCGTGTTCTGAGTGT-1	T cells
GCAAACTGTCGATTGT-1	Monocytes
GCGCGATAGGATGCGT-1	B cells
GTCCTCATCTAAGCCA-1	T cells
AAGCCGCCACGAAACG-1	NK cells
TGGACGCGTAGAAGGA-1	mDCs
TGCCAAAAGCCGATTT-1	Monocytes
CTCCTAGTCGTACCGG-1	T cells
CGGACTGAGCTGCAAG-1	Doublets
CTCGAGGCATGCCTTC-1	mDCs
GTGAAGGAGCCAGAAC-1	mDCs
GGTGCGTTCGCAGGCT-1	Monocytes
CAGAATCGTCTAGAGG-1	T cells
CTTACCGCATACTACG-1	Monocytes
GTGAAGGGTTGGTGGA-1	T cells
CTGCCTACATACGCCG-1	T cells
ACCGTAACAGGACCCT-1	B cells
GTAACGTCACAGAGGT-1	NK cells
GACGGCTGTTGGTAAA-1	T cells
TGACTTTAGAACTGTA-1	B cells
CAGCCGAAGGTAGCTG-1	T cells
GCTTCCACACGAGAGT-1	Monocytes
TACAGTGAGTACGCCC-1	T cells
TGCGTGGAGGTCGGAT-1	T cells
CTACGTCGTTTGCATG-1	Monocytes
GTTCGGGGTCGAGATG-1	T cells
AAGGAGCAGTTATCGC-1	Monocytes
TAGACCACAGAGTGTG-1	B cells
CCTTCGAAGCGGATCA-1	Monocytes
GCGCGATAGACTACAA-1	T cells
CATTCGCGTACTCAAC-1	Monocytes
CGAATGTGTAGAAAGG-1	Doublets
CTCGAGGTCTTTACAC-1	T cells
TGGCCAGTCCGGCACA-1	T cells
CTCATTAAGCTGCGAA-1	Monocytes
AAATGCCTCAGGCCCA-1	B cells
TACTCGCGTACCATCA-1	T cells
CGAGCCAAGGTGGGTT-1	T cells
CAACTAGTCAGCATGT-1	B cells
CACACTCGTACAGTTC-1	B cells
GTTACAGAGGTAGCCA-1	T cells
GATTCAGTCGCGTAGC-1	T cells
CATCCACGTGGAAAGA-1	T cells
TCAGCAAAGAAGCCCA-1	Monocytes
CATGACAGTAGCCTCG-1	mDCs
GGGTTGCAGAAGCCCA-1	T cells
CGAGAAGGTACTCGCG-1	T cells
ACAGCTAAGCCGATTT-1	Monocytes
CATCAAGCATGCAACT-1	T cells
CTCTGGTCACGAGAGT-1	Monocytes
CGGAGCTGTCTAGCCG-1	T cells
GTACTTTTCCTGCTTG-1	T cells
ATGTGTGAGGGCATGT-1	Monocytes
TTCGAAGTCTTCATGT-1	T cells
GATGAAACAGTAAGAT-1	T cells
TTCGGTCAGGTTACCT-1	Doublets
ACGAGGAAGAATGTTG-1	Monocytes
AGAGCTTAGAGCCCAA-1	Monocytes
GTCTCGTTCAACCAAC-1	Monocytes
CTCGTACGTCCGACGT-1	T cells
CGATTGACATACGCCG-1	mDCs
CGTTGGGCAGATAATG-1	Monocytes
TTTGTCATCCCAAGAT-1	Monocytes
CTAGCCTTCTCCAACC-1	T cells
AGTAGTCTCTGCGTAA-1	T cells
TTCCCAGAGAGTCTGG-1	T cells
AAGACCTGTGCAGGTA-1	B cells
CGTCTACCATATGGTC-1	T cells
CACATAGTCTCGCATC-1	Monocytes
CAAGTTGTCACGCATA-1	B cells
TTCCCAGCAATAGCGG-1	T cells
AGCAGCCGTTCAGTAC-1	B cells
CGTAGCGCACTGCCAG-1	T cells
AACTCAGCACGGTTTA-1	T cells
ATTATCCAGGGTCTCC-1	B cells
GTGCTTCAGGCTCTTA-1	mDCs
GCTGCTTAGCTCCTTC-1	B cells
CGAACATGTATTCTCT-1	T cells
AACTCCCCACCATGTA-1	T cells
CGTCCATAGTGGGCTA-1	mDCs
GCATGTAGTTCACGGC-1	T cells
CGTCTACGTGGACGAT-1	T cells
TCGTACCAGCCAGTTT-1	T cells
TGAGGGAAGTGGTAGC-1	Monocytes
CAGAGAGCAGTAGAGC-1	B cells
GAAGCAGAGGCACATG-1	T cells
CTCTGGTAGGAGTAGA-1	Doublets
CTGTTTATCAGTCAGT-1	Monocytes
AATCGGTCATCGTCGG-1	Monocytes
CAGCCGACACAGCGTC-1	T cells
AGTCTTTCATGTTGAC-1	T cells
CAAGATCGTCGCATAT-1	Monocytes
AAACGGGGTTTGCATG-1	mDCs
TGGGAAGCACAGAGGT-1	NK cells
CATCGAATCCTTTACA-1	B cells
AAATGCCTCACCAGGC-1	Monocytes
CGTCAGGCAGATGGCA-1	T cells
GAACATCAGCCTCGTG-1	Monocytes
CACATAGCAAGGACTG-1	T cells
TTGAACGCAGGAACGT-1	B cells
TCTTTCCTCGAACTGT-1	T cells
TCCCGATAGACTACAA-1	B cells
GAACCTATCGGTTAAC-1	T cells
CCTAAAGTCGAATCCA-1	T cells
GGTATTGAGTGTCCAT-1	T cells
TTAACTCGTCTGATTG-1	T cells
AGTGGGAGTGCCTTGG-1	T cells
TTAACTCAGAAGCCCA-1	T cells
CACCTTGGTCGAACAG-1	Monocytes
CTCTAATCACCTGGTG-1	T cells
CTGATAGAGGGTGTGT-1	T cells
TATTACCGTTATGTGC-1	B cells
GGAAAGCCAAGCCATT-1	T cells
CTCACACAGCGTTTAC-1	T cells
GTGCTTCCACCACGTG-1	T cells
CATGGCGAGCTGAAAT-1	pDCs
GAGTCCGGTCTCAACA-1	B cells
CCTAGCTTCCTAGTGA-1	B cells
GGGCATCGTAGCTTGT-1	mDCs
GCTGCGACATAACCTG-1	mDCs
CATGCCTCACCGAATT-1	Monocytes
GGGATGATCGGAAACG-1	T cells
GGCGACTAGTGTGGCA-1	B cells
CCTACCATCTGTTGAG-1	Monocytes
CAGAATCTCCAACCAA-1	T cells
CTTGGCTGTGTGACGA-1	T cells
TATCTCACAACGCACC-1	Doublets
GGCTGGTCAAGAAAGG-1	B cells
AAAGTAGAGGGCACTA-1	Monocytes
TGACAACCAAGCCTAT-1	Monocytes
GTATCTTAGTTGTAGA-1	T cells
CACAGGCTCAATACCG-1	Doublets
TACCTATCAGATGGGT-1	T cells
TGCGTGGTCACTCCTG-1	T cells
ACGAGGAAGTGGTAGC-1	B cells
CCGTTCATCGTAGATC-1	T cells
GACAGAGGTGGAAAGA-1	Monocytes
GGTGTTAGTGATGCCC-1	T cells
CTGCTGTGTAAATGTG-1	T cells
ACCAGTATCCTCAATT-1	T cells
GACAGAGTCTTGACGA-1	T cells
CGAGCCAAGCTACCGC-1	T cells
TGAGCCGCATCACCCT-1	T cells
AGTTGGTGTCTAAACC-1	NK cells
CTTACCGAGGGATGGG-1	T cells
TTCTTAGCAGCTGCTG-1	Monocytes
CAACCTCTCTGCTGTC-1	T cells
GGACAAGTCTCAAGTG-1	T cells
TCTGGAAGTACGCTGC-1	T cells
CTGATAGAGACGCAAC-1	T cells
CGACTTCTCAGTTCGA-1	T cells
GGACGTCAGAGTAATC-1	Monocytes
GCTTCCAAGCTACCGC-1	T cells
ATCATCTAGGCACATG-1	Monocytes
TGGGCGTCAAGTTAAG-1	T cells
ACTGCTCTCCTCATTA-1	T cells
GTAGTCATCACTTCAT-1	T cells
CAACCAATCTCGCATC-1	T cells
CATCAGATCGTCACGG-1	NK cells
AGTCTTTGTCCATGAT-1	Monocytes
CCAGCGAAGATCCGAG-1	T cells
TCAACGAGTCCGAAGA-1	Monocytes
GGCTGGTCACTGTCGG-1	Monocytes
TTCGAAGGTATTACCG-1	T cells
GTGGGTCGTCAGAGGT-1	Monocytes
CAAGATCTCACCTCGT-1	T cells
TGGGAAGAGTGGTCCC-1	Doublets
CAGCTGGGTAGTGAAT-1	B cells
GGTGCGTGTTGCGTTA-1	T cells
GACTGCGTCAACCATG-1	B cells
ACTATCTTCTACGAGT-1	T cells
GGTGTTAAGATCGATA-1	Monocytes
CTTGGCTTCTAACTTC-1	T cells
TTGCGTCAGACCCACC-1	T cells
GGCGACTGTTCTCATT-1	B cells
GAACGGAGTGTCAATC-1	Monocytes
TAAACCGAGATGCCTT-1	T cells
CTCGTACGTAGAGGAA-1	T cells
GAAACTCAGTACTTGC-1	mDCs
TGCGGGTCACATCCGG-1	T cells
GAACGGACAATCGAAA-1	B cells
GCTCTGTCAAGCGCTC-1	T cells
GATGAGGAGCTCTCGG-1	T cells
AGAGTGGTCGGTCCGA-1	Doublets
TTCTCAAGTTATCACG-1	T cells
AATCCAGTCTCCAGGG-1	T cells
CGAGCCATCCGAGCCA-1	Monocytes
TCGGGACGTGTGGTTT-1	T cells
CCGTGGAAGGAGTTTA-1	B cells
TCGTACCAGCGCCTCA-1	T cells
GACGCGTAGTGACATA-1	B cells
GCATGTATCACCCTCA-1	B cells
AGCTTGATCTTTAGTC-1	T cells
GCATGCGAGTACGTTC-1	T cells
CCTTTCTCATCGGAAG-1	T cells
GAAATGACAGATAATG-1	Monocytes
TCGGGACCACGGACAA-1	T cells
AACGTTGTCTTGTATC-1	T cells
AGCTCTCCATGGTCTA-1	Monocytes
AGTGTCATCCGCGGTA-1	T cells
CACACAAGTGAGTGAC-1	Monocytes
CTGTGCTGTCTCTTAT-1	B cells
ATCATGGCAGCCAATT-1	mDCs
CAGGTGCCAAGCTGTT-1	T cells
TACGGATTCTTGTATC-1	T cells
CGTGAGCTCGTTACGA-1	T cells
GTCTCGTGTGATGTGG-1	mDCs
CCGTGGAGTTCAGTAC-1	T cells
TATGCCCTCTGCTTGC-1	Monocytes
TCACAAGAGCAGCCTC-1	T cells
AAGACCTTCGAACGGA-1	Monocytes
ATAAGAGTCTGCAGTA-1	B cells
CTCAGAAGTATCGCAT-1	Monocytes
GCGAGAAAGAATGTGT-1	B cells
TCAGATGAGCTCCTTC-1	T cells
CGTCCATAGACCACGA-1	T cells
CTGAAACTCGTTTAGG-1	T cells
GCTTGAATCTTGAGGT-1	Monocytes
GTTACAGAGTTATCGC-1	Monocytes
AAGGCAGTCCTATGTT-1	B cells
ACGGGTCTCACTCCTG-1	T cells
GCTGGGTGTGACTACT-1	T cells
ACGTCAAAGACTTGAA-1	T cells
GGACAAGCAATCTACG-1	Monocytes
CATCAGATCCGCGCAA-1	B cells
GTCTCGTCAATGACCT-1	Monocytes
TGTGGTATCACGGTTA-1	Monocytes
ACGCAGCTCTCGAGTA-1	T cells
GACGCGTGTAGTGAAT-1	NK cells
GTCTCGTAGGGTTTCT-1	Monocytes
AGTGAGGTCTGTACGA-1	B cells
AACCGCGCACGGCCAT-1	T cells
TCACAAGTCCGTCAAA-1	T cells
TTAGTTCAGACTCGGA-1	T cells
CATATGGGTGGGTATG-1	T cells
CTGCTGTGTACCGTAT-1	B cells
GACAGAGGTCCTGCTT-1	B cells
CTACACCTCTTGCAAG-1	Monocytes
GTCAAGTGTGCAACGA-1	Monocytes
GACGTTAGTCGCGGTT-1	T cells
GGATGTTGTCACTGGC-1	T cells
CCGGGATCATGCATGT-1	B cells
CTGCTGTAGAATCTCC-1	T cells
CAGCTAAAGGCTCATT-1	Monocytes
TACTCATCATATACGC-1	T cells
CTCGGGACACATCCAA-1	mDCs
CCTAGCTGTGAGGCTA-1	T cells
CTACATTTCGGCATCG-1	B cells
GGGATGATCTACTTAC-1	Monocytes
GACAGAGAGGTGCTTT-1	T cells
AGCTCCTAGCTAGTTC-1	T cells
TAGTTGGTCAGTCAGT-1	T cells
TTCTCCTAGACGCAAC-1	Monocytes
TAAACCGTCACATGCA-1	Monocytes
CACAGTACATACGCTA-1	T cells
CCACGGACAGAGTGTG-1	T cells
AGCTCCTCACATGACT-1	T cells
CCCAGTTAGTTAGGTA-1	Monocytes
CTAGTGATCGCCTGAG-1	T cells
GGAACTTTCACTCCTG-1	Monocytes
CGTAGGCTCCAAGTAC-1	B cells
TGAAAGATCAAGCCTA-1	T cells
CGGAGCTTCGCAGGCT-1	T cells
CTGTTTACAGATGAGC-1	Monocytes
AAGGTTCCACGAAACG-1	NK cells
ACTTACTCACTGCCAG-1	Monocytes
GACCTGGGTCGCGGTT-1	Monocytes
ACTGTCCAGCTGAAAT-1	T cells
GTTCTCGCACCAGCAC-1	T cells
TCAGCTCTCACCACCT-1	mDCs
CTTAGGACAAGCCGTC-1	T cells
GGGAATGGTGTAACGG-1	T cells
TATCTCAGTATTAGCC-1	Monocytes
ATCTACTTCTGAGTGT-1	Monocytes
CAGATCATCAGCACAT-1	T cells
CGATCGGCAGTTCCCT-1	T cells
CATGACATCGGATGTT-1	T cells
ACATCAGGTTTGTTTC-1	T cells
TCGTAGAGTCCAGTTA-1	Monocytes
AGTGTCATCATAACCG-1	T cells
CTGTGCTAGACAATAC-1	Monocytes
CCTTACGAGGAGTAGA-1	T cells
CATGGCGGTCCAGTGC-1	T cells
GCTTGAACACAGTCGC-1	B cells
TGCGCAGGTCACTTCC-1	T cells
CCTTACGCATATACGC-1	B cells
CAAGAAAAGGCTAGGT-1	T cells
CTCGGAGGTCGACTGC-1	T cells
GATCTAGTCTCGAGTA-1	Monocytes
GTAACGTCACCCATGG-1	T cells
TACCTTAGTTTCGCTC-1	T cells
CGTAGCGTCTGGCGTG-1	B cells
TCACGAAGTTGCTCCT-1	T cells
CCCATACGTCCTCTTG-1	Monocytes
ACCTTTACACATTAGC-1	B cells
AAGGTTCTCTCGTATT-1	B cells
GTCCTCATCTTCAACT-1	T cells
GTCACAAGTATTCGTG-1	Monocytes
GTATCTTGTGTGAATA-1	Monocytes
TGCTGCTAGGTTCCTA-1	Monocytes
GTGTGCGGTCCTAGCG-1	T cells
TCTTTCCTCTGGCGAC-1	T cells
CTAGCCTGTCGGCATC-1	T cells
ATCCACCCATTACGAC-1	Monocytes
TGACTTTAGTGTGAAT-1	Monocytes
GCTGGGTAGAAGGTTT-1	T cells
AGACGTTGTGAAATCA-1	T cells
CAGAGAGCACATGGGA-1	B cells
ATCACGACATGCAATC-1	T cells
CTTAGGAAGCTAGGCA-1	T cells
GGGTCTGTCTCATTCA-1	T cells
CACTCCATCGTGACAT-1	T cells
AATCGGTGTGACTCAT-1	T cells
TGCCCATAGTGGTAGC-1	B cells
GATCTAGAGTTGTAGA-1	Monocytes
AACCATGCAGTCCTTC-1	Monocytes
ATCGAGTGTGCAGTAG-1	T cells
TAAGTGCTCGGTCTAA-1	B cells
GTAGGCCGTTTGGCGC-1	mDCs
TTGGCAATCACCCTCA-1	T cells
CACTCCAGTAACGCGA-1	T cells
TACTTGTAGCGCCTTG-1	T cells
CAAGTTGCATCAGTCA-1	T cells
GAAGCAGCACCATGTA-1	T cells
ACGAGGACATCAGTCA-1	B cells
TAGGCATCAGAGCCAA-1	T cells
ATCTACTTCGTTTATC-1	T cells
CCGTACTAGGATGCGT-1	T cells
ACGCCGAAGATTACCC-1	pDCs
GCATGATCAAGCTGAG-1	Monocytes
CTTGGCTGTCACAAGG-1	Doublets
GCAAACTGTCTTCAAG-1	Monocytes
ATGAGGGCAGACGTAG-1	NK cells
TGCTACCAGCGATATA-1	T cells
TCGTACCAGGATCGCA-1	Monocytes
TACGGTACAACACCCG-1	T cells
CATCGGGCAGTGAGTG-1	Monocytes
GACGGCTCAATGGATA-1	T cells
TGCGTGGCATTACCTT-1	T cells
AACTCAGGTTTGACAC-1	mDCs
GGGTTGCTCGCCAAAT-1	T cells
GCATGCGAGGATGTAT-1	T cells
TTTACTGCATCAGTAC-1	B cells
TTCCCAGCACCTATCC-1	NK cells
AACTTTCAGGGTGTTG-1	T cells
GCAAACTAGAAGGACA-1	Monocytes
CTCGTCACAAGGCTCC-1	T cells
CGAATGTCACCAGGTC-1	T cells
CTACACCTCAGCGATT-1	T cells
TTGGAACCACTCTGTC-1	NK cells
GGTGAAGCAGGCAGTA-1	B cells
TCATTACCAACGATCT-1	mDCs
TGACGGCGTATGAAAC-1	NK cells
ACGCCAGGTGAACCTT-1	B cells
CGGACTGCACCATCCT-1	Monocytes
GATCGTAGTATAGTAG-1	B cells
GCTGCGACAATGGAGC-1	Monocytes
CTCGTACTCAGCTTAG-1	T cells
CGGCTAGTCTACCTGC-1	T cells
CAAGAAACACGTCTCT-1	T cells
ATCTGCCAGTTGTAGA-1	T cells
AGTGAGGGTTCGGGCT-1	T cells
ACACCGGAGCTAAGAT-1	Monocytes
ACGCCGATCTTAACCT-1	pDCs
TCGTAGACAATTGCTG-1	T cells
GGCAATTGTCGCTTCT-1	T cells
TACTTACCAAACGCGA-1	B cells
ACTATCTTCCGTACAA-1	Monocytes
CATGGCGTCGGACAAG-1	T cells
GTTAAGCTCCACTCCA-1	pDCs
CATTCGCCAAAGGTGC-1	B cells
CCTCTGAGTCTTTCAT-1	T cells
CAGAATCCATTGAGCT-1	NK cells
GCATGCGGTCAACTGT-1	T cells
AAGGCAGTCGTACGGC-1	T cells
CGTCTACAGTCTTGCA-1	T cells
GCATGTAGTTAAGACA-1	B cells
ATCATCTCATCCAACA-1	Monocytes
TTCTTAGCAGAAGCAC-1	T cells
CTTGGCTTCGTTGACA-1	B cells
ATTGGACGTCTGCGGT-1	T cells
AAACGGGAGTGTCCAT-1	T cells
CTAGCCTAGGGAGTAA-1	T cells
CTAGAGTCATCCTTGC-1	T cells
TAGAGCTAGGTTACCT-1	T cells
ACGCCAGAGGGTATCG-1	mDCs
CCACGGACATGCCTTC-1	T cells
GGCGACTGTAGCCTAT-1	B cells
TTAACTCCAGCTGTAT-1	Monocytes
TTCGGTCTCGTACGGC-1	T cells
GGTATTGGTGTCCTCT-1	T cells
GTCATTTAGCTATGCT-1	B cells
TTCTTAGTCGTAGGTT-1	T cells
CGTAGGCCATCTATGG-1	T cells
TAGGCATTCCCAAGTA-1	T cells
TTTGCGCTCAATCACG-1	T cells
TAGTGGTGTGCGAAAC-1	B cells
CGTTGGGAGAAGGCCT-1	T cells
TAAGCGTAGTTTCCTT-1	T cells
CGAACATAGCAGCGTA-1	Monocytes
TCATTTGAGAATAGGG-1	T cells
AGACGTTTCACGCATA-1	Doublets
GGAATAATCGGAAACG-1	T cells
GCGCCAATCATCACCC-1	T cells
GACTGCGGTCTAAACC-1	T cells
CCCAGTTGTAGCGTAG-1	Monocytes
CGAGAAGGTTCCACGG-1	Monocytes
CGTGTAATCATTTGGG-1	T cells
AGAGCTTCACATGACT-1	T cells
ACGCAGCGTTTACTCT-1	B cells
AGAGCGATCCGCAGTG-1	T cells
TAAACCGAGCTATGCT-1	T cells
AACGTTGCACACCGCA-1	Monocytes
GGAAAGCTCTTGACGA-1	T cells
CGCGGTACAAACGTGG-1	NK cells
TTCTCAACAGACAAAT-1	B cells
TACTCGCCAGGATCGA-1	T cells
ACGATGTAGATCTGCT-1	T cells
GGCGACTTCAACCAAC-1	T cells
CTCGAGGCAATAACGA-1	T cells
GACTGCGAGCAGACTG-1	B cells
GTACGTATCAAACCAC-1	T cells
GCGAGAAGTTACTGAC-1	B cells
GGTGTTAAGCGTGAGT-1	Monocytes
AGAGCTTGTCCGAATT-1	T cells
AGGTCATGTTACCGAT-1	T cells
TCAGCTCAGTAGTGCG-1	B cells
TGTCCCACATGGTCTA-1	Monocytes
AGCTCTCTCTTCAACT-1	Monocytes
TCTGGAAGTAAGGGCT-1	T cells
TGAAAGAAGCCACTAT-1	T cells
ACGTCAAGTAAGAGAG-1	T cells
GCATGCGCAGATAATG-1	Monocytes
TATCAGGTCTTGTATC-1	Monocytes
TGCGGGTAGTTGAGTA-1	T cells
CAGCTGGGTTGCGTTA-1	Monocytes
CACATAGCACCTGGTG-1	T cells
GCTGCTTAGAGCTGCA-1	NK cells
GCTCTGTCACATAACC-1	NK cells
GCTCCTACAAAGTGCG-1	B cells
TGGTTAGTCCCTTGTG-1	T cells
TAGTGGTGTTGGTGGA-1	T cells
GAACCTACAGCGAACA-1	B cells
ATTGGTGGTCTTGTCC-1	Monocytes
CAGATCAGTAAGTAGT-1	Monocytes
ACGCCAGTCAAGCCTA-1	pDCs
CATCCACTCCTTAATC-1	T cells
GTTCTCGGTGGCAAAC-1	T cells
GTCACGGCAGATCTGT-1	B cells
CCTATTAGTCTAGCCG-1	T cells
CCGGGATAGTAGTGCG-1	T cells
GATGCTAGTGTTAAGA-1	B cells
TTAACTCCACTTACGA-1	Monocytes
CGTCAGGCACCGGAAA-1	mDCs
ACAGCTACACTAAGTC-1	Monocytes
ATAACGCAGGTGACCA-1	T cells
CTCATTAGTCTCCATC-1	Monocytes
TGACTAGGTTAAGTAG-1	T cells
CTAGAGTAGTGGGCTA-1	mDCs
TGACAACTCATTGCCC-1	T cells
AACTCTTCAAGGGTCA-1	T cells
CGGCTAGGTATGAATG-1	T cells
CCTCTGATCTTTACGT-1	T cells
ATTGGTGCATCAGTAC-1	B cells
GGGAATGCACGGCCAT-1	T cells
GAAATGAAGTCGTTTG-1	Monocytes
TACCTATGTCACACGC-1	Monocytes
AGGGAGTGTCTTCTCG-1	Monocytes
GAAGCAGAGACAAAGG-1	Monocytes
AACACGTAGGTGCTAG-1	Monocytes
CCATGTCGTTACGACT-1	Monocytes
ACTGAACAGCGTTGCC-1	T cells
CACACCTGTATCGCAT-1	T cells
AAGGAGCGTACTCAAC-1	Monocytes
GTGCGGTTCTAACTGG-1	T cells
GGAGCAAAGTGTTTGC-1	Monocytes
CAAGGCCGTATCAGTC-1	T cells
AACACGTGTATCAGTC-1	pDCs
CTCGAAACATGACATC-1	NK cells
ATAAGAGTCCGATATG-1	B cells
AAAGTAGAGAAGGTGA-1	T cells
TGAGCATAGTGACTCT-1	T cells
CGACCTTGTTGATTGC-1	Monocytes
CACACCTTCGAATCCA-1	mDCs
ACGCAGCAGTGACATA-1	T cells
CACCTTGCAATGAATG-1	T cells
TTTATGCAGATAGCAT-1	B cells
TGAGCCGCAGGACCCT-1	Doublets
ACTTTCATCCACGACG-1	T cells
CAGCCGATCTGTCTCG-1	T cells
GCTGCTTAGGTAGCCA-1	T cells
TCCCGATTCCAGTATG-1	T cells
ACATACGAGTTACGGG-1	T cells
CCTCTGAAGTGGTCCC-1	T cells
CGAGAAGCACCATGTA-1	Monocytes
CTAAGACGTGTGAATA-1	Doublets
CCGTGGAAGTGATCGG-1	T cells
GTATTCTCACGTAAGG-1	T cells
TCACAAGTCCTCGCAT-1	T cells
TATCAGGGTACCGTAT-1	T cells
GATCTAGGTTATGTGC-1	T cells
ACGAGGAAGCAATATG-1	T cells
GCAGCCAAGTCTTGCA-1	T cells
TGTGGTACACAAGCCC-1	T cells
CAGAGAGCAGTGGAGT-1	T cells
ATGAGGGAGAGTCGGT-1	Monocytes
GGGCATCTCAGAGGTG-1	T cells
ACTTACTAGATCCTGT-1	B cells
AGCAGCCAGCATGGCA-1	mDCs
CTAAGACTCCCTAATT-1	T cells
GTGCATAAGGACGAAA-1	T cells
TCAGGTACAATCGAAA-1	Monocytes
GAGTCCGCATAAAGGT-1	T cells
CAGCATATCGTTGCCT-1	T cells
GCATGTAGTCAACTGT-1	T cells
TCTCATAAGAAACCTA-1	B cells
AATCGGTTCACCGTAA-1	pDCs
TAGAGCTGTGGCCCTA-1	Monocytes
CACACTCCACCCATGG-1	T cells
AACCGCGGTAAGTGTA-1	T cells
TCGAGGCCATCCTTGC-1	Monocytes
CATCGAACATCAGTCA-1	B cells
TGCGCAGAGTCAAGCG-1	pDCs
CAAGTTGTCTATGTGG-1	T cells
TGGCGCATCGGAGGTA-1	B cells
ACACTGATCGTTACGA-1	T cells
CCTTACGAGATCCGAG-1	T cells
CTGAAGTAGCGATAGC-1	B cells
CCGGTAGAGTTGCAGG-1	NK cells
CGTTAGAGTCACTTCC-1	Monocytes
AAGTCTGAGAGGGATA-1	Monocytes
TCCACACAGTCCGTAT-1	Monocytes
CTACGTCTCTGGAGCC-1	Monocytes
GCGCAGTCATTTGCCC-1	Monocytes
GGAATAACAAGGTTTC-1	B cells
CTCATTACACGGCCAT-1	Doublets
GTCACGGAGCGATCCC-1	T cells
CCTTTCTTCGTCCGTT-1	T cells
GTGAAGGAGGATGGAA-1	T cells
CACAGGCGTGGTACAG-1	Monocytes
GTCCTCAAGCCGCCTA-1	T cells
TGGCCAGCAGCCTTTC-1	T cells
TCATTACCATTGAGCT-1	Monocytes
CGGACGTCAGGCGATA-1	T cells
GACGTTACAGTAGAGC-1	T cells
CGACTTCAGAAGAAGC-1	Monocytes
AAAGCAAGTTGTTTGG-1	T cells
TGCCCTACACTGTCGG-1	Monocytes
CACCTTGCACAGCCCA-1	Monocytes
TCTATTGAGCTAGTCT-1	B cells
ACTGAGTAGTTGTAGA-1	T cells
TGCGCAGGTCGAGTTT-1	T cells
ACTGATGCACGTTGGC-1	B cells
GATCGTACAAGAGGCT-1	T cells
TTTCCTCTCAGAGACG-1	T cells
GGTGAAGAGTACGATA-1	Monocytes
CTGATCCCATCCTAGA-1	T cells
CGAGCCATCCACGTTC-1	B cells
GAACGGAAGATATGGT-1	T cells
CGGAGTCTCTTTAGTC-1	T cells
GCTGGGTGTAGTAGTA-1	T cells
CGTTGGGCATCCGGGT-1	T cells
GTATCTTAGTATTGGA-1	T cells
GCACATAGTAGAGGAA-1	T cells
ACACTGACAAGTAATG-1	T cells
CGATGTACAGCCTATA-1	T cells
ACGGGCTGTTGACGTT-1	T cells
CTAGTGAGTCAATGTC-1	B cells
CTACACCGTTTGACAC-1	B cells
TCATTTGAGTACACCT-1	T cells
TTTCCTCAGTGACTCT-1	mDCs
GTGGGTCGTTCGTGAT-1	T cells
GCGAGAATCTAACTCT-1	T cells
ACTGAGTGTAGCTAAA-1	T cells
CAGCTGGCATTCACTT-1	T cells
TTCCCAGGTCTTTCAT-1	T cells
TATTACCCACTGAAGG-1	T cells
GAATAAGAGAAACCAT-1	T cells
ACTGATGTCTTGGGTA-1	NK cells
GTTCTCGGTCCTGCTT-1	Monocytes
GCTTGAACAACGCACC-1	B cells
CATCCACAGCCCTAAT-1	T cells
TGCTACCCATTTCAGG-1	Monocytes
CGAGCACTCCACGTTC-1	T cells
GTATTCTAGTATCTCG-1	T cells
TCAGCTCCATTGGTAC-1	B cells
CGGACTGAGTTAGGTA-1	B cells
GGCCGATAGTGCTGCC-1	T cells
GCTTCCAAGGAATCGC-1	T cells
CGGTTAAGTAAGCACG-1	B cells
AGCGGTCTCCCTTGCA-1	B cells
CCACGGACATTAACCG-1	B cells
GAGGTGATCCTAGTGA-1	Monocytes
ACGCCGAAGTCGTACT-1	T cells
TATCAGGTCTGAGGGA-1	T cells
GGTGCGTTCAAACCGT-1	T cells
GTCAAGTCACACATGT-1	T cells
TCAATCTCATGCCACG-1	mDCs
CTCGTCAGTAACGACG-1	B cells
TAGACCAAGTGGTAGC-1	T cells
GTCGTAATCCGAGCCA-1	T cells
TCGGGACGTTTGGGCC-1	T cells
GTCCTCATCACAATGC-1	mDCs
GCGCCAATCGTAGGTT-1	Monocytes
GTACGTAAGGCTAGCA-1	T cells
GAACGGATCAAGATCC-1	T cells
GGGAGATCATACGCCG-1	T cells
CAGCTAACAAGCGTAG-1	NK cells
CGGACGTAGACTCGGA-1	T cells
CCGGGATTCTTGTCAT-1	B cells
GTACTCCTCCGTCATC-1	T cells
TGGCGCAGTCTCGTTC-1	T cells
TGGTTCCGTCCTCTTG-1	T cells
CTCGGGAAGGTGCAAC-1	T cells
CGCGGTAAGGGAACGG-1	Monocytes
AGACGTTGTGACCAAG-1	T cells
AACTCCCGTTGGTAAA-1	T cells
CGAACATTCCGAAGAG-1	Monocytes
ACTTGTTGTGTCCTCT-1	T cells
CCTTCGAAGTTAGCGG-1	T cells
CTACATTCATCGACGC-1	NK cells
TCCACACTCCGCGTTT-1	B cells
CTCACACTCTGCCAGG-1	T cells
CTCGGAGCAGACGCCT-1	B cells
GTATTCTGTCGACTGC-1	Monocytes
TTTACTGGTGTTAAGA-1	Monocytes
CGATTGAGTAGATTAG-1	Monocytes
CCTTCCCGTTCCACAA-1	T cells
TCACAAGTCGCCTGAG-1	T cells
AACCGCGTCTGCTTGC-1	T cells
TACAGTGGTTTGCATG-1	T cells
GAACGGAGTAATCACC-1	T cells
CTACATTGTCACTGGC-1	B cells
GTCCTCAAGAGGTAGA-1	Monocytes
GGACGTCCATCCGTGG-1	T cells
ACCGTAAGTGGTCTCG-1	Monocytes
TACACGATCTAAGCCA-1	T cells
CATCGAAAGCAGGCTA-1	Monocytes
ATGTGTGAGAGGGATA-1	T cells
AGGTCATTCCGCGGTA-1	T cells
GACCTGGGTCCAGTTA-1	Monocytes
ACTGATGCATGGGACA-1	T cells
CAAGGCCGTGAACCTT-1	pDCs
ACGCAGCTCTACTATC-1	T cells
TCTCATAAGATAGGAG-1	pDCs
CGTAGCGCATGTTCCC-1	T cells
CAGAGAGAGTTATCGC-1	T cells
CATGCCTCAAGTAATG-1	T cells
CATGGCGTCGCCTGTT-1	T cells
TGCACCTGTATAAACG-1	T cells
CTCCTAGCATTGGTAC-1	Monocytes
GTAGTCATCCAGTATG-1	Monocytes
TCTGGAAAGAACTGTA-1	T cells
TTTACTGGTAGGAGTC-1	Monocytes
CCGTTCACATGAAGTA-1	T cells
CACAAACAGCCAGGAT-1	T cells
GCGCGATTCCTTTCTC-1	T cells
TGTGGTATCTAAGCCA-1	T cells
GTGTGCGTCGGCTTGG-1	B cells
AACGTTGCAGTTAACC-1	T cells
AACGTTGAGCGATATA-1	Monocytes
GTAGTCACAAGCCGTC-1	T cells
AGGCCACCACCGAATT-1	T cells
CCATTCGAGCTAACTC-1	Monocytes
ACGAGCCAGAGTACCG-1	B cells
ATGTGTGGTGCACTTA-1	B cells
CCATTCGAGTCCATAC-1	Monocytes
TTAGGCACATGTAGTC-1	Monocytes
TAGCCGGTCAATCTCT-1	Monocytes
GTGAAGGCACCCTATC-1	T cells
CTTCTCTCATGCCCGA-1	T cells
GACCAATTCCTAGAAC-1	NK cells
ATCATCTAGCGCCTCA-1	T cells
CCGTACTGTCATACTG-1	T cells
GTACTCCAGACGCTTT-1	T cells
TATTACCTCCCATTTA-1	Monocytes
GCACATAAGCCGCCTA-1	T cells
AGCTTGAGTTAAGAAC-1	T cells
GGTGTTACATGCAATC-1	Monocytes
CGTTAGAGTCTCTTAT-1	Monocytes
CCATTCGGTAGCCTAT-1	T cells
AGTGGGAGTGCCTGTG-1	T cells
ATCGAGTCATCACAAC-1	T cells
CGGAGCTTCTACCTGC-1	T cells
GTGTGCGAGTACGATA-1	T cells
TGAAAGATCCAATGGT-1	T cells
GTTCTCGCATGCCTAA-1	T cells
ATCCGAACAGTTCCCT-1	T cells
ATCCACCCAACGCACC-1	Monocytes
GGCGACTAGTGTGAAT-1	Monocytes
CCTTCGACACTATCTT-1	Doublets
ACACCAAAGAAACGCC-1	NK cells
GATGAAACACTGTGTA-1	Monocytes
TGGTTCCGTCCATGAT-1	Monocytes
AACTTTCCACACCGAC-1	B cells
GTAACTGGTTGGACCC-1	T cells
ACTGAACGTAGCTTGT-1	Monocytes
TTTGGTTAGGATGGTC-1	T cells
TGCCAAAGTTTGACAC-1	T cells
GACGTTACAAGAAGAG-1	mDCs
GATGAAAGTGGTACAG-1	T cells
GGCTCGATCCAGGGCT-1	Monocytes
CCTTCCCTCTCCAACC-1	Monocytes
ATCGAGTAGCTCTCGG-1	Monocytes
ACTGAGTCATCCCATC-1	mDCs
TGTTCCGCAGCATGAG-1	mDCs
TCGCGAGCACGAAGCA-1	Monocytes
CTGATAGTCTTTACGT-1	T cells
TCGGTAAGTGTTCTTT-1	T cells
CGCCAAGTCGCTTGTC-1	T cells
AACTCCCCACTACAGT-1	B cells
TGAGCCGCAAGCCCAC-1	T cells
GTAGGCCTCCATGAGT-1	T cells
GGAAAGCAGGAGTAGA-1	Monocytes
ACTTTCATCACAACGT-1	Doublets
GGGCATCAGTACGATA-1	T cells
CACATTTGTAGCTCCG-1	T cells
CGGGTCAAGAACAATC-1	NK cells
CCACTACCATCGGAAG-1	T cells
AAGGCAGCAAATCCGT-1	T cells
TGCCCTACACAGGAGT-1	NK cells
ATGGGAGGTAGCGTGA-1	T cells
GCCAAATCATACAGCT-1	T cells
GACGCGTGTACTTAGC-1	T cells
TGACTTTCATGACGGA-1	B cells
GACGTTAAGACTAGGC-1	T cells
GTCACGGGTAAGTTCC-1	pDCs
CGTCAGGGTAAAGTCA-1	Monocytes
TGCGCAGTCTCTAAGG-1	Monocytes
GATTCAGCAATGGAAT-1	T cells
CGCGGTATCAACTCTT-1	T cells
GATCGCGGTTACTGAC-1	B cells
ACGGGCTGTAAACACA-1	T cells
AGCGTCGCAGTCAGAG-1	B cells
AGGTCATGTTCGCTAA-1	T cells
ATTGGACGTCGACTAT-1	T cells
AGTTGGTAGGACATTA-1	T cells
GCGGGTTAGTGTACTC-1	Monocytes
GAACCTATCATTTGGG-1	Monocytes
CATTCGCGTTCCACGG-1	T cells
CTGTTTAAGATATACG-1	T cells
TGCGGGTCACAGTCGC-1	mDCs
GGATGTTTCAGTCAGT-1	mDCs
GGAAAGCAGCCAGAAC-1	Monocytes
CCACCTATCATCTGTT-1	Monocytes
AGCTCTCGTTGATTGC-1	pDCs
TTCGGTCAGCCACTAT-1	NK cells
TAGTGGTCATCCAACA-1	B cells
TTGTAGGGTATAGGTA-1	Doublets
CGTCTACGTCTAACGT-1	T cells
ATAACGCCACAGGCCT-1	Monocytes
TTAGGACAGCGTAATA-1	B cells
AAATGCCCAGACACTT-1	Monocytes
GCAGCCAGTATGAAAC-1	T cells
GATGCTACACATCTTT-1	B cells
GCATGTACAGCTGCTG-1	T cells
GCTTGAACACCAGTTA-1	T cells
TCACAAGCACGTTGGC-1	T cells
CATTATCTCTCTAGGA-1	T cells
CACCTTGAGCAGATCG-1	T cells
TTAGTTCGTTCCATGA-1	Monocytes
GGTATTGCAGCCTTGG-1	T cells
CACAAACAGTGTGGCA-1	T cells
GACTGCGAGGCATGTG-1	T cells
GAAACTCTCACTCCTG-1	Doublets
CTCTGGTAGTTAGGTA-1	T cells
GCTTGAAGTTAGATGA-1	Monocytes
TGCCCTACAATAGCGG-1	T cells
AACTCCCTCACGGTTA-1	T cells
GTGCAGCCATGCGCAC-1	B cells
AAGGTTCTCTACTATC-1	NK cells
GATGAAAAGTGCCAGA-1	Monocytes
GTGTTAGTCGCGGATC-1	T cells
AGCGTATAGATACACA-1	Monocytes
TAGACCAGTAGGGTAC-1	Monocytes
TCAATCTGTAAGGGAA-1	T cells
CGATGTAGTGGGTCAA-1	T cells
CCTACCATCGAATGGG-1	Monocytes
TTGCGTCCAATAGCGG-1	B cells
CGATGTATCGTACCGG-1	NK cells
CAGCAGCGTCGGCTCA-1	T cells
CTCTAATAGGTTCCTA-1	B cells
GATGAGGAGTTGAGTA-1	T cells
ACGGGCTGTCATACTG-1	T cells
CATCAGAGTAACGACG-1	T cells
CGAACATTCACATGCA-1	T cells
GTACGTACACACGCTG-1	T cells
GGGAGATGTTCCACGG-1	T cells
TGAGAGGGTTCAGACT-1	T cells
TGCGGGTTCGTAGGTT-1	T cells
TATGCCCGTGAGGGAG-1	Monocytes
CGCGGTATCGGATGGA-1	B cells
CTCTAATTCGGCCGAT-1	NK cells
CTCGAGGGTCGCCATG-1	Doublets
TAAGAGAAGCTAACAA-1	T cells
TACGGGCGTGCCTGCA-1	T cells
AGATCTGGTGTTCGAT-1	Monocytes
TTTGTCACAGGTCCAC-1	NK cells
TGTCCCAAGCGTAGTG-1	B cells
TATCAGGCAGTGGAGT-1	Monocytes
GGGACCTAGCCTATGT-1	T cells
TAAACCGTCCCGGATG-1	Monocytes
GAACCTAGTCTCTTTA-1	Monocytes
GTTCGGGCAAGTTAAG-1	B cells
TACGGTATCCGAAGAG-1	Monocytes
TTAGTTCCATCTGGTA-1	T cells
CCTAAAGGTGATGTCT-1	B cells
TTAGGCAAGTTGCAGG-1	Monocytes
GCATGTAAGTACGTAA-1	Monocytes
CGTCCATTCTTCGAGA-1	T cells
ACGATGTAGTCCAGGA-1	Monocytes
AGCGGTCAGTCCGGTC-1	Monocytes
TGGACGCCAGCATGAG-1	T cells
ACACCGGGTATGAATG-1	Doublets
GTGCAGCTCAAGGTAA-1	NK cells
TTGGAACGTACCAGTT-1	T cells
TGAGCATTCTTGGGTA-1	Monocytes
CTGAAGTTCGTATCAG-1	T cells
TCGAGGCAGGAGTTTA-1	T cells
TACTTACCAATCGAAA-1	B cells
CGGCTAGCAGCTGTTA-1	pDCs
GCTGGGTGTAGCGTAG-1	mDCs
TCAATCTCATTCACTT-1	B cells
ACGCCGAGTCATATCG-1	T cells
TTCTCCTTCCGCGGTA-1	T cells
GTACTTTCACGTCAGC-1	T cells
CGTTGGGAGATCACGG-1	T cells
CATCGGGCAATACGCT-1	Monocytes
CACCTTGGTATTCGTG-1	T cells
GATCTAGAGTTATCGC-1	Monocytes
CCGTTCATCGCCCTTA-1	T cells
TACCTATCACGGACAA-1	Monocytes
GTCCTCACACTCTGTC-1	T cells
TCGGGACGTTCTGAAC-1	T cells
AGTCTTTTCCCAACGG-1	T cells
GAGCAGAAGACAAAGG-1	T cells
GATCGCGGTCCTAGCG-1	T cells
CCAATCCTCTGCTGCT-1	T cells
TTAACTCCAATGGAGC-1	B cells
CCACGGAGTAATAGCA-1	Doublets
GTGCAGCTCAGTTAGC-1	B cells
GTAGTCACACGACGAA-1	T cells
TTAGTTCGTCACTTCC-1	B cells
GTCTCGTTCCCACTTG-1	Monocytes
GGCCGATAGAACTGTA-1	T cells
GTTCGGGGTTAAGTAG-1	T cells
CTTGGCTTCCTAAGTG-1	Monocytes
ACGGCCAAGCGACGTA-1	B cells
TCTCTAACAACACCCG-1	mDCs
TCAGATGAGTCCATAC-1	B cells
GCACTCTGTTAGATGA-1	T cells
CCGGTAGCATCAGTAC-1	T cells
TCAGGATGTCCTAGCG-1	Monocytes
TGTATTCAGGCCCTCA-1	Monocytes
CATCGGGAGTGAATTG-1	T cells
TGAGCCGTCATTTGGG-1	T cells
CAGGTGCAGGGTGTGT-1	T cells
CTTAACTTCTCGAGTA-1	Monocytes
TATCAGGCACCACGTG-1	Monocytes
AGGGATGCAAGTAGTA-1	Monocytes
TAGTGGTCATCGGACC-1	T cells
CATATTCGTGCTTCTC-1	T cells
GCTGCTTCATTCGACA-1	T cells
GACAGAGGTGTATGGG-1	Monocytes
GTGCTTCAGGCTAGAC-1	mDCs
AACTGGTGTGAGCGAT-1	NK cells
GCATGATTCGGTTCGG-1	T cells
GGCCGATGTGGTACAG-1	B cells
AGGCCACAGGGTGTTG-1	Doublets
CGGAGCTAGATGCCAG-1	T cells
GCACATAAGTTAGCGG-1	T cells
GAACATCTCTGGTTCC-1	B cells
GTACGTATCTCACATT-1	Monocytes
GCGCAACTCTCATTCA-1	T cells
CTAAGACAGCGTAGTG-1	Doublets
TGGGCGTAGCTATGCT-1	Monocytes
ACACCCTGTTCTGGTA-1	Monocytes
ATGGGAGAGCACACAG-1	T cells
TCCCGATTCCTACAGA-1	T cells
AGTTGGTGTGGTACAG-1	T cells
TCGTAGACACTAAGTC-1	T cells
TCTATTGTCATACGGT-1	B cells
GACTAACAGCCCGAAA-1	T cells
TCGGGACAGTGTACGG-1	NK cells
CGCGGTATCGTACGGC-1	Monocytes
GGCAATTGTGTTGGGA-1	Monocytes
GTTCGGGAGAGTCTGG-1	T cells
ATAGACCAGTGGAGAA-1	T cells
CTCTGGTGTAAATGAC-1	T cells
TGGGCGTTCTTCAACT-1	Monocytes
TTCTACATCATTGCCC-1	T cells
TGTGGTAGTACCTACA-1	T cells
ACGTCAAGTATGGTTC-1	T cells
TCTGAGAAGTGCAAGC-1	T cells
GGCCGATTCGGTGTTA-1	T cells
TCAGGTACAGTCAGCC-1	B cells
TTTATGCGTACTCTCC-1	B cells
CGTCCATTCGTTTGCC-1	T cells
GCATACACAATTGCTG-1	T cells
GAATAAGTCGGACAAG-1	Monocytes
CTCTACGAGCGACGTA-1	T cells
ATCACGAAGAAGCCCA-1	T cells
CGTCCATGTGACTCAT-1	Monocytes
CTACGTCAGTGACTCT-1	B cells
GCAATCAAGACCGGAT-1	B cells
AGCGTCGGTGCGAAAC-1	T cells
ACTTACTAGCTATGCT-1	T cells
TCTCTAATCCAGATCA-1	Monocytes
CCTTTCTAGTACGCCC-1	B cells
CGGACGTCAGGGAGAG-1	Monocytes
CTGCTGTAGATATACG-1	Monocytes
CGTGAGCGTTGTCGCG-1	pDCs
ATAGACCGTAAGGGAA-1	T cells
GATTCAGCATCACCCT-1	B cells
TGGACGCTCCTGCAGG-1	Monocytes
GACGTGCAGAGGTACC-1	T cells
TACACGAAGGGTCTCC-1	T cells
TTCTCAACAGGACCCT-1	T cells
CTTTGCGTCGAGAACG-1	T cells
GGCTGGTCAAAGCGGT-1	T cells
TCGGGACAGCGATTCT-1	T cells
ACGTCAAAGATCACGG-1	T cells
GTGCATAGTAAGAGGA-1	B cells
AGTGGGAAGACCCACC-1	Monocytes
CTCTAATAGAGGTAGA-1	B cells
CAGCTAAAGATGCCTT-1	T cells
ACTGTCCGTTAAGTAG-1	pDCs
CGTGTCTGTAAACCTC-1	T cells
CAGATCATCTTGCAAG-1	T cells
GCAGTTATCTCGATGA-1	Monocytes
GGGATGAAGTTTCCTT-1	B cells
CATGCCTAGGTTCCTA-1	B cells
ATCATGGCAGGGTACA-1	T cells
TCTTCGGTCCTCAACC-1	T cells
TCATTACCACAGAGGT-1	mDCs
CCGGGATAGATGAGAG-1	B cells
CGTGTAATCTCGCTTG-1	T cells
GTCCTCATCTATCCTA-1	B cells
TTCTTAGTCACGCGGT-1	T cells
TGTTCCGAGAAGGTGA-1	T cells
TGACGGCCAGGGAGAG-1	T cells
CAAGTTGCAATCTGCA-1	T cells
GAGCAGAAGTATCTCG-1	T cells
AGCATACTCGGATGTT-1	T cells
TCAGCTCGTATCTGCA-1	T cells
TGCACCTTCCTTTACA-1	B cells
CTAGAGTGTACAAGTA-1	B cells
CACCACTCACGTTGGC-1	B cells
GTCGTAACAATGGAAT-1	T cells
GATCGTATCGGCGGTT-1	Monocytes
TACCTATTCCAGAAGG-1	T cells
CGGAGCTAGCTGCCCA-1	Monocytes
TCAACGAAGGCCATAG-1	T cells
AACTTTCAGAGCTATA-1	T cells
TGATTTCGTTCACCTC-1	B cells
TTAGTTCTCAAGAAGT-1	B cells
GACTAACGTTTGACAC-1	T cells
ACGGGTCAGCTACCTA-1	B cells
AAGCCGCTCAAGGTAA-1	Monocytes
TTGCGTCAGTCATGCT-1	B cells
GACGCGTAGTCCGGTC-1	T cells
CCATGTCTCGTCTGAA-1	NK cells
CGAACATGTTACAGAA-1	mDCs
TCGTACCGTTCAGCGC-1	T cells
GACTACAGTACTCGCG-1	B cells
AACACGTTCTTACCGC-1	T cells
GAATAAGTCCTTGGTC-1	NK cells
CTTCTCTTCCTATGTT-1	T cells
GATGCTACAGGTTTCA-1	T cells
GACGCGTGTTCCATGA-1	Monocytes
AACTCAGGTTGTCGCG-1	T cells
GTACTCCCAATAACGA-1	Monocytes
ATTGGTGGTCGCTTTC-1	T cells
CTGCCTACATTAACCG-1	T cells
TACTCGCGTACCAGTT-1	T cells
GTCTCGTAGTGCCATT-1	T cells
TCACGAACAGTGACAG-1	T cells
CCTATTATCAAGCCTA-1	T cells
TCAGCAACAATCACAC-1	T cells
GTGCTTCAGCCCAGCT-1	Monocytes
CTCTGGTTCCTCTAGC-1	T cells
ACACCGGCACAGGTTT-1	NK cells
ACACCAATCATTGCGA-1	Monocytes
TTCTCAACATTGTGCA-1	T cells
GACGCGTAGGGAAACA-1	Monocytes
CGGCTAGAGAGCCTAG-1	B cells
AACTGGTAGCTGCCCA-1	NK cells
CGATCGGAGGATATAC-1	T cells
GCATGCGAGCGCTCCA-1	Monocytes
TTTGTCAGTTAAGACA-1	B cells
GACCTGGAGTGTGGCA-1	T cells
GTAGTCAAGCGTAGTG-1	T cells
GCATGCGCAAGCGAGT-1	T cells
AATCCAGAGCCAACAG-1	T cells
GAAACTCGTGTAAGTA-1	T cells
AAGGTTCGTTCACGGC-1	T cells
GCGACCACAGTCGATT-1	mDCs
ACGGCCAGTTAAAGAC-1	T cells
CAACCAAAGCGTAGTG-1	Monocytes
TCTCATACAGGATTGG-1	Monocytes
CCTACACCAAGCTGGA-1	T cells
AGGCCGTAGCTCCTTC-1	Monocytes
TCATTTGCACCTCGGA-1	T cells
TCAGCTCCAAGTAGTA-1	T cells
TTCCCAGTCTTGTACT-1	Monocytes
TTGCCGTTCTGTCAAG-1	T cells
TACTCATAGGTAGCTG-1	Monocytes
CATTATCCAGTGGGAT-1	B cells
CCACCTAAGTGGAGAA-1	T cells
ACGAGCCTCCTCAACC-1	B cells
AGCGTATCACGAGAGT-1	Monocytes
CATCAAGTCTTAACCT-1	T cells
GTAACGTTCAGTCCCT-1	Monocytes
ACATACGCAGCTGCAC-1	T cells
GTACTCCCACGAGAGT-1	T cells
CGTTCTGGTTATCCGA-1	B cells
CTGCGGACAGTATGCT-1	B cells
GCACTCTTCATTCACT-1	B cells
GTCACGGGTCAGCTAT-1	B cells
CGGAGTCGTCGAATCT-1	T cells
ACACCCTAGTGTTAGA-1	T cells
AACTCCCCATTGGTAC-1	T cells
GACGGCTTCTCAAGTG-1	T cells
CCGTACTCACACATGT-1	T cells
TTTATGCAGCAGACTG-1	T cells
AGCTCCTAGATGCCTT-1	T cells
GCGCGATCAGTCACTA-1	T cells
CTCCTAGAGTTCGCGC-1	Monocytes
ATCTACTCAAACGCGA-1	B cells
GAAATGACAAGACACG-1	B cells
CTCGGGACAAGCGCTC-1	T cells
CAGCATAGTTAGATGA-1	B cells
GGCTGGTCAGCGATCC-1	B cells
GATCGATAGCTAACTC-1	Monocytes
CGTGAGCTCAGCTGGC-1	T cells
CGCTATCAGACTTGAA-1	T cells
CGTTCTGAGCTCAACT-1	T cells
AGTAGTCCACCGAAAG-1	T cells
TCGGGACTCTTGCATT-1	Monocytes
TGAGGGAAGAGTACCG-1	Monocytes
GGACATTGTCTCAACA-1	Monocytes
GACACGCCAGCTCGCA-1	Monocytes
CTGTGCTAGTCCATAC-1	Monocytes
CGATCGGCACGTAAGG-1	B cells
ACCAGTACAGACAGGT-1	Doublets
CGACTTCCACTTCTGC-1	B cells
GTGTGCGGTAGCTTGT-1	T cells
ATGTGTGTCAGGTAAA-1	T cells
CCATGTCGTGCACGAA-1	T cells
TGCGGGTAGTGGCACA-1	T cells
TCGTACCAGCAGGCTA-1	Monocytes
AGTGAGGCATGGTCTA-1	NK cells
CGGCTAGCACATCCGG-1	Monocytes
GTGCGGTGTAAGTAGT-1	B cells
GACGCGTAGCAGGCTA-1	NK cells
GACAGAGAGCTTTGGT-1	Monocytes
GTGCTTCCAGCTGTAT-1	T cells
TTTGCGCAGGACACCA-1	Monocytes
ATTACTCAGAGGGATA-1	B cells
TTAGTTCCATGTAAGA-1	B cells
CCACCTATCCAACCAA-1	Monocytes
TTCTCAATCGCATGGC-1	T cells
AAGGCAGGTAGTGAAT-1	Doublets
GAGCAGATCGGAGCAA-1	T cells
CTTTGCGCACTATCTT-1	B cells
CGAATGTTCCACGACG-1	Monocytes
AAACCTGTCGTGGTCG-1	T cells
CCTACACGTCTCAACA-1	T cells
AGCGTATTCTACTTAC-1	Monocytes
CACATAGGTCATCGGC-1	T cells
AACTCAGCAACGATGG-1	T cells
AGCGGTCTCCGAATGT-1	Monocytes
ATCTGCCTCAACACCA-1	T cells
CCACGGAAGTGTACCT-1	T cells
ATCGAGTCAGGTCCAC-1	B cells
TCTGGAAAGAGTACAT-1	T cells
GGCCGATTCACCCTCA-1	T cells
TACGGGCGTTAGGGTG-1	Monocytes
GTTCATTAGCTGTTCA-1	T cells
ATAACGCTCTTGTTTG-1	T cells
CGAATGTGTACCATCA-1	mDCs
CTACACCTCATAGCAC-1	pDCs
GACAGAGAGACTTTCG-1	Monocytes
GTGAAGGAGACAAGCC-1	T cells
TGTCCCACAATGTAAG-1	T cells
TTCTTAGTCCCATTTA-1	B cells
AAAGCAAGTAAACACA-1	NK cells
CCGTTCACAAGGCTCC-1	T cells
CACACTCCAGTAACGG-1	B cells
GTGCGGTCAATCGGTT-1	NK cells
TCACAAGAGGAGTAGA-1	T cells
CGTGTCTTCATGCAAC-1	Monocytes
TACACGACACGTCTCT-1	T cells
GATGAGGTCCATTCTA-1	Monocytes
AACCGCGCATGGTCTA-1	T cells
ACTTGTTTCTGGAGCC-1	T cells
CATCGAAAGGGCTTGA-1	Monocytes
TAGAGCTGTCCTCCAT-1	Monocytes
GTAGTCATCTGTGCAA-1	T cells
GCAGTTATCTTAGCCC-1	Monocytes
CTGTGCTTCCGCGGTA-1	Doublets
CTACCCAGTCGTCTTC-1	T cells
CTGAAACTCTAACTCT-1	T cells
CCTCTGAAGCAATCTC-1	T cells
CCGTGGAAGTAGGCCA-1	mDCs
AACTCTTGTTACGCGC-1	T cells
GAATGAACAAACGTGG-1	T cells
GTATCTTCAGATTGCT-1	T cells
CACAGGCCAAGCGCTC-1	Monocytes
GCGAGAAGTTCTGGTA-1	T cells
CGGAGCTGTCAAAGAT-1	T cells
GCTTGAACACAGACAG-1	Monocytes
TTAGTTCCATGGTAGG-1	T cells
TGGCGCAAGCTAAGAT-1	T cells
TACAGTGGTATTACCG-1	B cells
CCTTACGTCTGCGACG-1	Monocytes
AGCGTCGCACTCGACG-1	T cells
TCAGCAAAGGGATCTG-1	T cells
TTAGGCAAGCCGCCTA-1	mDCs
GTCTTCGGTGACTCAT-1	T cells
ACGGGTCGTGCTCTTC-1	T cells
GCGAGAACAAGTTGTC-1	mDCs
CCTTTCTTCTACTCAT-1	T cells
AACTCTTCAGTCTTCC-1	T cells
ACCAGTAGTGAGTGAC-1	T cells
TTCTCCTAGTGATCGG-1	Monocytes
TGACAACTCCCTCTTT-1	B cells
TCAATCTAGCGCTTAT-1	B cells
CAGCATAAGACTTGAA-1	mDCs
ACGAGGAAGCACACAG-1	Monocytes
TGGCCAGGTGCCTTGG-1	T cells
GCGAGAACATTGGTAC-1	Monocytes
GGTGCGTGTCAGGACA-1	mDCs
TATGCCCAGGGCATGT-1	Monocytes
AAAGTAGTCTCAAGTG-1	T cells
AGTGGGAGTAGCTAAA-1	T cells
CTAATGGAGTGACTCT-1	T cells
GTCCTCACAGAGTGTG-1	T cells
AGTGGGATCTTAACCT-1	mDCs
ACTGATGCAATACGCT-1	T cells
CGTTGGGAGCTGTTCA-1	T cells
AGGCCGTCAGCGTAAG-1	Doublets
GCGCAGTAGCACCGCT-1	Monocytes
TAGCCGGAGATATGGT-1	B cells
CAGCGACAGAGTGACC-1	Monocytes
TGGTTCCGTCGGATCC-1	T cells
TTAACTCTCGGAGGTA-1	T cells
ACGTCAATCTGGCGAC-1	T cells
ACGAGCCAGGGTCTCC-1	T cells
AGGCCACGTGATAAGT-1	Monocytes
ACGATACCATGCCTAA-1	Doublets
ACTGAGTCAGCGAACA-1	NK cells
AGTAGTCGTAACGACG-1	T cells
GTAACTGTCCATGCTC-1	T cells
CGTTAGATCGTACGGC-1	T cells
CGCCAAGCATCTCCCA-1	T cells
CAGCTAAGTCTTGATG-1	Monocytes
TGAGCATTCTTGCATT-1	B cells
CAGAGAGAGCTAAACA-1	NK cells
ACGGCCACAGGGTTAG-1	T cells
CATTATCGTGGGTCAA-1	Monocytes
TTAGGCAAGGGAACGG-1	T cells
CATGACAGTGATGCCC-1	T cells
AGTGTCAAGGGTGTTG-1	pDCs
CTGCCTAAGATATGGT-1	B cells
ACTGAGTGTCATACTG-1	T cells
CAGCCGACAGATTGCT-1	Doublets
AGGTCCGAGAATTGTG-1	Monocytes
TCAGATGTCAGGTTCA-1	Monocytes
GTCCTCACAATCGGTT-1	Monocytes
CTTAGGAGTCTCCATC-1	mDCs
CCTTCCCTCCCTGACT-1	T cells
ATCCACCAGCGTTTAC-1	T cells
GTATCTTCATATGAGA-1	Monocytes
ATTGGACGTTCACGGC-1	T cells
GGTGTTAAGCTAGCCC-1	T cells
TGTGTTTCACCATGTA-1	Monocytes
TACCTATGTCTTCGTC-1	T cells
GACTACAGTCGCGTGT-1	B cells
CGCGGTACATGCATGT-1	Monocytes
CCACTACAGCTAGTGG-1	Monocytes
CCACGGAGTGAGGGAG-1	Monocytes
TTTGCGCTCTCTTGAT-1	B cells
TTGTAGGGTTGAACTC-1	T cells
CAAGATCGTCGAACAG-1	T cells
CAGCAGCGTATTCGTG-1	T cells
TGTTCCGAGAGGTTAT-1	NK cells
CTACGTCAGAGGTTGC-1	T cells
CAGTCCTAGATCCCAT-1	T cells
GAGTCCGCAGCTCGAC-1	T cells
AAACGGGTCTGGTATG-1	T cells
CATCCACGTTCCGGCA-1	T cells
GCTTCCAGTCGCATAT-1	Monocytes
GACTACAAGCCCTAAT-1	T cells
GAACATCCACAAGCCC-1	T cells
GTGTTAGTCACGCATA-1	Monocytes
TGCGTGGTCATACGGT-1	Monocytes
GTACTCCAGGATATAC-1	T cells
TCAGGTAGTAGCGTGA-1	B cells
AGGCCGTAGGAATTAC-1	Monocytes
CCTAAAGAGCTGTTCA-1	T cells
CGTTGGGAGTTACGGG-1	B cells
ATCCGAAGTAACGCGA-1	T cells
AGGTCATGTTCCACGG-1	T cells
TCTTCGGGTAGCGCTC-1	B cells
CATGGCGCATATACCG-1	Monocytes
CACTCCAGTCTCGTTC-1	B cells
TACGGTATCAACACTG-1	T cells
ATCTACTAGAGCTTCT-1	Monocytes
TCCACACGTCTTGTCC-1	T cells
AGCGGTCAGAGTAATC-1	Monocytes
ATCCACCCAACTGGCC-1	B cells
TCTCATAGTAGCTTGT-1	T cells
AGCGTCGGTGTCAATC-1	Monocytes
ATGGGAGAGTCCCACG-1	Monocytes
TCGGTAAGTCGCATAT-1	T cells
TCAGCTCTCGTCGTTC-1	T cells
GGATTACGTACAAGTA-1	T cells
CGCGTTTAGCAGCGTA-1	T cells
GTCTTCGAGGGCTCTC-1	B cells
TCGTAGACATCTCGCT-1	B cells
GTGTGCGTCTAACTGG-1	T cells
GCTCCTAGTTCTGAAC-1	T cells
CTCAGAAGTCAAAGAT-1	B cells
TAAACCGGTAGCAAAT-1	T cells
GCTCTGTGTAGGGACT-1	Doublets
TTTGCGCCATGCCTTC-1	T cells
ACCTTTACATGGTCAT-1	NK cells
GTCACGGTCAGCCTAA-1	Monocytes
AGGTCATTCACTTACT-1	B cells
CAGCAGCGTCTAGCCG-1	T cells
GCTGCGATCCGAGCCA-1	B cells
AGCGTCGCAGCAGTTT-1	T cells
TTCGGTCAGTGCAAGC-1	T cells
CTGATAGGTACCGAGA-1	B cells
CAAGGCCAGAGCTATA-1	Monocytes
CCCTCCTTCGGAGCAA-1	T cells
CACATAGCATAGAAAC-1	Monocytes
ATCCGAAGTGACTCAT-1	T cells
TGAGAGGGTTGAGTTC-1	B cells
ATAAGAGCATCGGGTC-1	T cells
TCGTACCTCGGCGCAT-1	T cells
TCGAGGCAGGGAACGG-1	Monocytes
AGCGGTCAGATCACGG-1	T cells
AAGGTTCAGTGTACCT-1	T cells
TATTACCGTATAATGG-1	T cells
CAGCGACAGCATCATC-1	T cells
CTTGGCTTCTTAGAGC-1	T cells
GAGCAGACAGGATTGG-1	B cells
AACTCCCAGCGTGAAC-1	pDCs
GTTAAGCAGTGAACGC-1	Monocytes
CAGTAACAGCCAACAG-1	Monocytes
AGTGAGGTCTTTACGT-1	B cells
ACGAGCCTCTGTTTGT-1	T cells
GGCAATTGTAAGAGGA-1	T cells
TTAGTTCGTAGCGTCC-1	T cells
GGAGCAAAGATGTGGC-1	Monocytes
CGATGTAGTAGAGCTG-1	B cells
GGAGCAAAGATGCCAG-1	T cells
GTGCTTCGTTGTCTTT-1	T cells
TACTCGCGTATAATGG-1	Doublets
AGCCTAAAGGGAGTAA-1	T cells
GGGAGATAGAAGGGTA-1	T cells
CATGACACAGATGAGC-1	Monocytes
CTGGTCTGTACTCGCG-1	Monocytes
CTGGTCTTCGCAAACT-1	T cells
CCTACCAAGCGCTTAT-1	NK cells
TGACTAGGTTAAGAAC-1	NK cells
GTGTTAGTCGGCGGTT-1	Monocytes
TCGTAGATCTGGTGTA-1	T cells
CCTACACAGCACACAG-1	T cells
TGCCAAACACAGGTTT-1	T cells
ACGAGCCCAGGGTTAG-1	T cells
CGTTCTGGTTCCAACA-1	T cells
TTCCCAGGTTATCGGT-1	T cells
AGCTCTCAGTGACTCT-1	B cells
CTCTGGTGTTAAGGGC-1	Monocytes
CTCACACTCAGTTGAC-1	NK cells
GGACAGACAGCTTCGG-1	T cells
CCCATACTCAATACCG-1	T cells
TCAGCTCCAATGTAAG-1	B cells
TCTCTAATCACTCCTG-1	T cells
CGTAGCGAGCGTCTAT-1	Monocytes
GGTATTGTCTGACCTC-1	mDCs
GTAGGCCAGGATGGAA-1	T cells
TCATTACGTCTCATCC-1	T cells
TACCTTAGTTACTGAC-1	Monocytes
TTGGAACTCGCATGAT-1	Monocytes
ACTGATGCAAGAAAGG-1	Monocytes
CACACAAAGTTATCGC-1	T cells
CCACCTAGTACCGTAT-1	Monocytes
CCTAGCTCACGTAAGG-1	B cells
CTAATGGCAAGCCGCT-1	T cells
GTGCTTCCAGGGTTAG-1	T cells
GCATGATTCACAGTAC-1	T cells
ACGTCAAAGGGTCTCC-1	Monocytes
AGTGAGGGTTTAAGCC-1	T cells
CGTCTACCAGCCTGTG-1	T cells
CCAATCCGTCTAGGTT-1	T cells
CCATTCGAGACACTAA-1	T cells
GTGCATAGTAACGACG-1	mDCs
TATGCCCCATTTGCCC-1	Monocytes
ACTTACTCAAGCCGCT-1	T cells
TCAACGAAGCTTATCG-1	Monocytes
GCTCTGTAGCGCCTCA-1	T cells
TCGTAGACAGTTTACG-1	B cells
ACGCCGAGTGCTAGCC-1	T cells
CAACCTCAGATAGGAG-1	Monocytes
CAGCGACGTGCCTTGG-1	T cells
TGTCCCACACTAAGTC-1	T cells
ACGGGTCAGTCGATAA-1	Monocytes
TCTCATACACGCATCG-1	T cells
GAGCAGATCCGGGTGT-1	Monocytes
CCAGCGACACAACGCC-1	T cells
TTGTAGGCACCATCCT-1	Doublets
AACTCAGGTGTAAGTA-1	Doublets
TAGCCGGCACTAAGTC-1	T cells
GTCCTCACAAACCTAC-1	T cells
CGGACACAGCGCCTCA-1	Monocytes
CTGTGCTAGTTACGGG-1	T cells
GCGGGTTAGTCGATAA-1	NK cells
CGTAGGCCATGCCCGA-1	B cells
ATCCACCAGAGCTGGT-1	T cells
ACTATCTGTCGCATAT-1	Monocytes
CGTGAGCGTCTCTCGT-1	T cells
TGCGGGTTCTGGTGTA-1	B cells
GTCACGGCATCGATGT-1	B cells
CTCGAGGAGGCTATCT-1	T cells
GCTGCAGGTTGTGGCC-1	T cells
ACCAGTAAGGGCTCTC-1	T cells
GGATTACAGCTTCGCG-1	B cells
GTCAAGTAGGGCTTGA-1	T cells
ACGAGGATCTACTATC-1	T cells
GCGAGAAAGTTAAGTG-1	Monocytes
GCTGCTTCACAGCGTC-1	NK cells
GATGCTAGTGTGTGCC-1	T cells
GTATCTTAGTGTTAGA-1	T cells
CACCAGGCAATCGAAA-1	Monocytes
CCTATTAGTCAAAGCG-1	T cells
AGGTCATCAGCTTCGG-1	Monocytes
TACGGATAGATGTTAG-1	mDCs
AAACCTGAGAAGGCCT-1	Monocytes
CCTCAGTTCACGGTTA-1	T cells
CGATGTAGTGTCGCTG-1	T cells
CCACTACGTAGCGCTC-1	T cells
TATCAGGGTTGATTGC-1	T cells
CTAGAGTCATGCCACG-1	T cells
GTCGGGTGTGCAGTAG-1	Monocytes
TCAACGACACGTCTCT-1	T cells
CTACCCAGTGGTAACG-1	Monocytes
CTACATTAGCTTATCG-1	T cells
GGGAATGCATGATCCA-1	Monocytes
CACTCCACAGTGAGTG-1	B cells
TTAGTTCTCGCGATCG-1	T cells
TCGCGTTTCATGGTCA-1	NK cells
GAACCTAAGCCTATGT-1	T cells
CAGTAACCATGCCACG-1	Monocytes
TGTTCCGAGGGTTCCC-1	NK cells
GACCAATTCCGGCACA-1	Monocytes
TGATTTCTCAGCTCTC-1	T cells
CTCTGGTGTCGTCTTC-1	T cells
TACACGAGTACCGTTA-1	B cells
TCCCGATGTCTCAACA-1	Monocytes
TATCAGGGTTACTGAC-1	T cells
CTTGGCTGTCTGCGGT-1	Monocytes
CGCGGTACAAGGTGTG-1	T cells
CAGAGAGGTTCGTGAT-1	Monocytes
GGATTACAGGCTATCT-1	T cells
ACACTGATCCTTCAAT-1	T cells
CTCGTCACAATCGAAA-1	NK cells
TTAACTCTCAGCTTAG-1	Monocytes
GCGAGAACACAACGTT-1	T cells
CGAGCACGTTACTGAC-1	Monocytes
ATTATCCAGAGGGCTT-1	T cells
TTCGGTCTCCTGCAGG-1	B cells
CCCAGTTGTTGTACAC-1	T cells
GTGCAGCTCATACGGT-1	T cells
CTAAGACTCGGACAAG-1	T cells
ACGCCAGAGAATAGGG-1	B cells
GAACATCAGTACGCGA-1	T cells
AGTGAGGGTTCCACAA-1	Monocytes
AAAGCAAAGTGTCCAT-1	pDCs
GGAGCAAGTCCGTGAC-1	mDCs
GTTTCTAGTAAATGTG-1	T cells
CCATTCGCACATCCAA-1	T cells
TTGAACGTCCGTACAA-1	T cells
AGGGAGTTCAAGCCTA-1	T cells
TGGTTAGGTTACTGAC-1	T cells
CAGTAACTCAAAGTAG-1	B cells
AAACCTGAGCGCCTCA-1	T cells
CTGATCCGTGCAACTT-1	Monocytes
ATCCACCCACAGTCGC-1	T cells
GACGGCTCACTCTGTC-1	B cells
ACCAGTATCCGTACAA-1	pDCs
AGGTCATTCCTTAATC-1	mDCs
CACACAACAGTCTTCC-1	T cells
TTGGCAATCACTCTTA-1	T cells
GTCATTTGTCTCAACA-1	B cells
GACGTGCTCCGCATCT-1	T cells
TGTGGTACAGTCCTTC-1	Monocytes
GTGGGTCCATACGCCG-1	B cells
TTGGCAATCTCCGGTT-1	T cells
CGAGAAGGTGTTTGGT-1	T cells
CTAAGACAGTATGACA-1	T cells
CAGTAACGTACAGACG-1	Monocytes
CTTTGCGCATGCTAGT-1	B cells
TGATTTCAGCGAGAAA-1	Monocytes
TACGGGCCATCCTTGC-1	Monocytes
CATCCACAGCGACGTA-1	B cells
CGTCCATCACAGCGTC-1	B cells
GACCTGGGTCGACTAT-1	Monocytes
CCATTCGGTGGCAAAC-1	Doublets
GCCTCTAAGGCAGGTT-1	T cells
AGCCTAATCTCGATGA-1	T cells
TAGCCGGGTCTAGTCA-1	T cells
CATCAGAAGGGTATCG-1	T cells
GATCGTAAGGTGCACA-1	Monocytes
AACCATGAGAGTACCG-1	mDCs
CCTCAGTCATGCTGGC-1	T cells
CGTCTACGTGACTCAT-1	T cells
CAAGAAAAGACTAGAT-1	Monocytes
CATTCGCTCTATCCCG-1	T cells
ACACCGGCAGCTGCTG-1	T cells
AGCTTGAAGCAATATG-1	Monocytes
CTAAGACGTAGCGCTC-1	T cells
AACTCCCTCGTATCAG-1	T cells
GGGTCTGCAGCTTCGG-1	B cells
CATGCCTTCGGCGCTA-1	Monocytes
ATCACGATCATCGCTC-1	B cells
CCTACCATCCAAACAC-1	Monocytes
AGATTGCGTTAAGAAC-1	T cells
CGGTTAAGTGATGCCC-1	T cells
AACTGGTTCGGAGGTA-1	B cells
GTTCATTAGGGTGTGT-1	B cells
GGTGCGTAGCGCCTCA-1	NK cells
TGCCCTACATCCCATC-1	T cells
GTCGGGTCACGTTGGC-1	Monocytes
TCTCTAATCAGCAACT-1	T cells
ATTATCCCAGTATAAG-1	T cells
CCACCTAGTTGTGGCC-1	B cells
ATCGAGTAGCCAGAAC-1	T cells
TTAGGACAGTGTGGCA-1	Monocytes
GCGGGTTGTGAAAGAG-1	T cells
CTGATCCTCTCTGAGA-1	T cells
GGTGCGTAGTACGATA-1	Monocytes
GCCAAATGTCTCCATC-1	T cells
AAACCTGCAGGCGATA-1	mDCs
GATGCTAGTTGATTCG-1	T cells
ATCGAGTCAAAGGTGC-1	Monocytes
GGGAGATTCATAGCAC-1	T cells
GCGACCAGTTCCCTTG-1	T cells
TGAGCATTCCAGATCA-1	T cells
CCACCTACAAGCCGTC-1	T cells
GGGAATGGTCGCTTCT-1	Monocytes
CACACAATCCTGTACC-1	Monocytes
TACTTGTCAGGCTCAC-1	T cells
ACGGGTCGTCGACTGC-1	Monocytes
TTTCCTCCAATCTACG-1	T cells
GACGGCTCAGTCCTTC-1	B cells
TACCTTACATCCGGGT-1	B cells
TGACGGCTCGTTGACA-1	T cells
AAGGAGCCAAGTTAAG-1	T cells
TCAGCAACAATGGAGC-1	T cells
CCTAGCTGTTACGCGC-1	T cells
GACCTGGTCTACCTGC-1	B cells
GACAGAGAGATCACGG-1	Monocytes
CAAGATCCATGGATGG-1	Monocytes
GCCAAATAGCGATATA-1	T cells
TGTGTTTGTACCGTTA-1	T cells
ACATGGTCATTTCACT-1	B cells
TTCGAAGGTTAAGACA-1	T cells
TCTTTCCCACACCGAC-1	Monocytes
TTTATGCAGGCCCTTG-1	Monocytes
GTAGGCCGTTCAGCGC-1	T cells
ACGGGCTGTTATGCGT-1	T cells
CCTTACGAGCCAGTTT-1	T cells
TGGCTGGCAATTGCTG-1	Monocytes
CCGGGATTCTCCAGGG-1	T cells
GATCTAGTCTTGTACT-1	T cells
CCCTCCTTCGCATGGC-1	T cells
GTGCGGTCATCCGGGT-1	Monocytes
TGACAACTCAGTACGT-1	Monocytes
TCTGGAATCAGTCAGT-1	T cells
CGGAGCTGTCCAAGTT-1	T cells
CTACGTCCATTGGCGC-1	Monocytes
TGATTTCCAGCTCGAC-1	T cells
ACTTGTTAGTGTCCAT-1	Monocytes
GCACATAGTCTTCTCG-1	T cells
GGTGCGTTCTCGCTTG-1	T cells
CGCGGTATCGGTGTTA-1	Monocytes
ATGGGAGCAGCTCGCA-1	mDCs
CTCACACGTATAGGGC-1	T cells
TTAACTCCAACACCTA-1	T cells
CGAGCACGTTGGTAAA-1	B cells
TCGTAGAGTCATACTG-1	T cells
AGAGCTTAGACTGGGT-1	B cells
CGTCAGGTCTGTCCGT-1	T cells
TTCTTAGCACATGTGT-1	Monocytes
CGGAGTCAGACAGAGA-1	T cells
TAAGAGAGTAGGGACT-1	T cells
TTGCGTCAGAGTCGGT-1	T cells
CACTCCAAGAACAATC-1	T cells
ATTGGACCAGAAGCAC-1	B cells
TCAGCAAGTTCACGGC-1	Monocytes
AAGGCAGAGTGGGTTG-1	Monocytes
CGACTTCCAGTAAGCG-1	Monocytes
CGATCGGCATAGAAAC-1	mDCs
GACCTGGCATGAACCT-1	T cells
CTCGTACAGACTGGGT-1	T cells
GTATTCTTCTGATACG-1	Monocytes
TTGCGTCCATCCTTGC-1	Monocytes
GTAGGCCCACCATCCT-1	Monocytes
CCGTACTTCGGTCTAA-1	T cells
TACAGTGAGCCGTCGT-1	T cells
ACTGAGTCATGATCCA-1	B cells
GGATTACCATAGGATA-1	Doublets
ATTGGACAGCACCGTC-1	T cells
GGAAAGCGTCGCTTTC-1	B cells
CAAGGCCTCCGTAGGC-1	Monocytes
CCTAAAGCACATTTCT-1	Monocytes
CGTAGGCCAGACTCGC-1	T cells
TGGACGCGTGTTCGAT-1	Monocytes
TGAGCCGAGGCCGAAT-1	B cells
ACTGAACCAGCCAATT-1	B cells
TCGTACCAGGCTCATT-1	T cells
TCAGCAAAGGCACATG-1	T cells
CATCGAATCAGCTTAG-1	T cells
TACGGGCTCGGACAAG-1	T cells
ATAGACCAGTACGCGA-1	T cells
ATCTACTGTTTAGCTG-1	T cells
AGTGAGGTCTCGGACG-1	Monocytes
GGACATTCACTCTGTC-1	mDCs
GTGCTTCGTTCCCTTG-1	T cells
AGCAGCCTCGAATCCA-1	Monocytes
GGGAGATCAAGGTTTC-1	T cells
CAAGTTGGTTCTGAAC-1	T cells
GTGCGGTAGACGACGT-1	T cells
GTCCTCACATCGGGTC-1	Monocytes
TTGCGTCTCTAACTTC-1	Monocytes
AGATCTGTCTGCGTAA-1	mDCs
TGGCTGGGTTACGACT-1	Monocytes
AGCTCTCTCACCGTAA-1	T cells
AGCCTAACAAGGACAC-1	T cells
TACACGAGTGCACTTA-1	NK cells
CATCGAAAGCTGTCTA-1	Monocytes
TTCTTAGGTTCACCTC-1	Monocytes
ACATGGTTCTGCAAGT-1	B cells
AGTGAGGCAAGTCTAC-1	Monocytes
GCTGCAGAGGTACTCT-1	T cells
GGGATGAAGCAGACTG-1	T cells
CGTGTCTAGTTAAGTG-1	T cells
GTAACTGGTCTCGTTC-1	NK cells
CACCACTTCCGATATG-1	T cells
CTGCGGAAGGGAAACA-1	Monocytes
AAGGAGCTCATGCAAC-1	B cells
GCTGGGTCAGTATGCT-1	T cells
GTATTCTTCGTTTATC-1	Monocytes
ATTGGACTCCTGTACC-1	NK cells
CATGACAAGGGATACC-1	T cells
CAGCTAAGTACTTCTT-1	Monocytes
AGCGGTCAGATCGGGT-1	T cells
AAGGCAGCAAATACAG-1	Monocytes
CACAAACTCCGTAGGC-1	T cells
TGCGCAGGTAGAGTGC-1	Monocytes
AATCGGTGTCGGATCC-1	Monocytes
TCACAAGGTTCAGTAC-1	NK cells
ACGAGCCCATTGAGCT-1	T cells
GATGCTAGTGAGTGAC-1	T cells
TGCACCTCAGGCTGAA-1	T cells
CCAGCGATCTTCATGT-1	Monocytes
ACTATCTTCGCCATAA-1	T cells
ATCGAGTGTACAGCAG-1	B cells
ATTTCTGTCTGGGCCA-1	Monocytes
TCGGGACTCTGAAAGA-1	T cells
TACTTGTGTCTCACCT-1	Monocytes
TCGGTAAGTTCTGAAC-1	NK cells
TCACGAACAGTAGAGC-1	B cells
TTTCCTCGTGGACGAT-1	T cells
TACCTATCACGGATAG-1	T cells
TCCCGATTCCTCATTA-1	T cells
GCTTCCACAGCTCGCA-1	B cells
ATGGGAGGTCTTGATG-1	T cells
GCAAACTAGCTGAACG-1	T cells
AAGCCGCCAATGTAAG-1	mDCs
TAAACCGCATGGTTGT-1	T cells
CGGACGTAGAGCTATA-1	Doublets
GTCACGGCAGCCTATA-1	T cells
ACTTGTTGTGACCAAG-1	T cells
CCTAGCTCAATGCCAT-1	B cells
GGACAAGAGAAGCCCA-1	T cells
AAGGCAGGTGGTAACG-1	Monocytes
TACCTATTCAGGCGAA-1	Monocytes
CCACCTAAGAGAGCTC-1	Monocytes
CTTCTCTTCGGACAAG-1	T cells
CTTACCGAGAAACCTA-1	T cells
AAGACCTAGAAACGAG-1	T cells
ATGAGGGTCGTCGTTC-1	B cells
AATCCAGCACAGGCCT-1	B cells
CCGGGATAGGGATGGG-1	T cells
CGGACTGTCAGTTCGA-1	T cells
TTGCGTCGTAATTGGA-1	T cells
GGAATAATCACCTTAT-1	Monocytes
GTACTTTCACTAGTAC-1	T cells
GACCTGGGTTCCACGG-1	Monocytes
CCCAATCCAAGGTGTG-1	B cells
AATCCAGGTAAAGTCA-1	Monocytes
TCACAAGGTGTCAATC-1	T cells
TACTCGCTCCACTGGG-1	Monocytes
CGGGTCAAGCGAGAAA-1	T cells
CGGACTGTCTTTACAC-1	T cells
AGTCTTTTCGGTCTAA-1	T cells
TGAGAGGTCTGCCAGG-1	T cells
CTCGTCACACCTGGTG-1	T cells
TACTCGCTCAACGGCC-1	Monocytes
ATCATCTAGACAAGCC-1	T cells
GCACTCTTCTGCTGCT-1	Monocytes
GGGAGATTCTGTACGA-1	T cells
CAGCCGATCGCATGAT-1	T cells
ATCATGGCAAATCCGT-1	T cells
GCGCAGTAGAGCTATA-1	T cells
CAGGTGCGTTATTCTC-1	Monocytes
TGGGCGTAGACTTGAA-1	T cells
TTGAACGCATAACCTG-1	Monocytes
AGCGTCGCACTGTCGG-1	Monocytes
TGTATTCCACAGAGGT-1	B cells
CAGAGAGTCTCCTATA-1	B cells
GCAGTTAAGGGATACC-1	B cells
GCTGCGAGTGGCAAAC-1	T cells
TCTCATAGTCGCGAAA-1	T cells
CGCGGTAGTTGGTGGA-1	Monocytes
GAAACTCCAGTGGGAT-1	B cells
GGGTCTGGTAGCAAAT-1	B cells
TTATGCTCATCACAAC-1	B cells
AAAGATGTCCGAATGT-1	T cells
ACACCAAAGGCAATTA-1	T cells
GGACAAGTCGTTGCCT-1	NK cells
CGTGTCTTCATCACCC-1	T cells
TGTGGTACAGTTAACC-1	T cells
TACCTTAAGATGTGGC-1	B cells
AATCGGTCAGGACCCT-1	Monocytes
TAGAGCTTCTACCAGA-1	T cells
GAACGGATCCCGGATG-1	B cells
AGCATACTCCTCTAGC-1	Monocytes
CGATTGATCAAACAAG-1	T cells
CGTCAGGTCTTCAACT-1	B cells
ACTTTCATCTCGTTTA-1	T cells
GAATAAGCATTCTTAC-1	Monocytes
ACTGATGTCAGTACGT-1	T cells
GCTTCCAAGTGCCATT-1	T cells
ATTACTCTCGGCCGAT-1	Monocytes
CGTGTAAAGCATGGCA-1	T cells
GCGCCAAGTACGAAAT-1	Doublets
CCCATACTCCTTTCTC-1	NK cells
GGCGACTGTTATGCGT-1	T cells
CGTGTCTTCTAACTCT-1	T cells
ATTGGTGAGGAATTAC-1	T cells
CCGGGATCAGATAATG-1	B cells
AAAGATGTCTGGTTCC-1	Monocytes
CACTCCATCGGCCGAT-1	T cells
CTGCGGAAGTGCGATG-1	T cells
GTCGGGTTCTGCTTGC-1	B cells
CCTACCAAGTTTGCGT-1	T cells
CGACCTTCAGTATCTG-1	Monocytes
GGCGTGTAGATCCTGT-1	T cells
TAGTGGTTCGAATGCT-1	Monocytes
GCATGTAAGAACTGTA-1	T cells
CTGCCTAAGTCCAGGA-1	B cells
TGACGGCCAGTATCTG-1	Doublets
GACCAATGTCAATGTC-1	Monocytes
AAGGTTCGTGTTCTTT-1	T cells
CCATGTCGTGCCTTGG-1	T cells
TGAGGGATCCTAAGTG-1	Monocytes
GTACGTAAGATCCCAT-1	Monocytes
GAATGAAGTGCACGAA-1	B cells
GTGGGTCAGTACGATA-1	B cells
AACTCAGGTTACCGAT-1	T cells
ATAACGCAGTGTCCAT-1	Monocytes
AGCTCTCAGATGCCAG-1	T cells
GATGAGGGTCGCTTCT-1	T cells
GATCGCGGTAGAAGGA-1	B cells
CAGCGACGTCTCCATC-1	B cells
ACATGGTAGCATGGCA-1	B cells
CAGAGAGAGTGCCAGA-1	Monocytes
ACCCACTTCGGAGCAA-1	T cells
CTCATTACATAGGATA-1	Monocytes
TTCGAAGGTACAAGTA-1	B cells
GCATACAAGACAGAGA-1	T cells
GCTGCTTCAGACGCTC-1	T cells
CTACACCTCTTACCGC-1	T cells
ATTATCCCAATAGCAA-1	T cells
TTCTTAGAGATCTGAA-1	T cells
TACTCATCAAGGTGTG-1	NK cells
GACGTGCTCGCATGAT-1	T cells
GACTAACAGTGAATTG-1	T cells
AATCCAGGTGAAATCA-1	T cells
GGCTGGTCATCGTCGG-1	T cells
CTAGAGTGTCATTAGC-1	T cells
CAACCAAGTAAGAGGA-1	Monocytes
CGAATGTCAACACGCC-1	Monocytes
GACTAACGTAAAGGAG-1	NK cells
ATCATCTTCGTCCAGG-1	Monocytes
CTAACTTGTATATGAG-1	T cells
TCTATTGAGGAGTCTG-1	T cells
ACAGCTAAGGACAGCT-1	T cells
TCATTTGAGCACACAG-1	T cells
CCCTCCTAGATGCCAG-1	Monocytes
CCTTCCCGTACCGAGA-1	B cells
AGAGTGGAGTACGATA-1	Monocytes
GGCTGGTAGCGGCTTC-1	B cells
GCTGCAGTCACTTCAT-1	Monocytes
GTGGGTCCAGCTCGAC-1	T cells
CGATCGGAGGACACCA-1	Monocytes
CAGATCATCATTATCC-1	T cells
TGATTTCCACAGCCCA-1	T cells
CAGCGACAGTGACTCT-1	T cells
CACAGGCAGTGGCACA-1	Monocytes
CTTCTCTCAATGGATA-1	T cells
TTCGAAGCACAAGTAA-1	Monocytes
GCGAGAAAGACAGGCT-1	T cells
GGCTGGTAGCCGCCTA-1	T cells
CCTCTGACATTACCTT-1	T cells
GCCAAATAGAGCCTAG-1	Monocytes
GACTACAGTTGTACAC-1	mDCs
TTCGGTCAGAGCAATT-1	T cells
ACTATCTGTTATCACG-1	Monocytes
GTCACGGGTCCGAAGA-1	T cells
TGCCAAAGTCTAGTGT-1	NK cells
CTCGGGATCGAATCCA-1	NK cells
TGGACGCGTAAAGTCA-1	Monocytes
TGGTTCCGTTATCGGT-1	NK cells
GTACTTTAGTCCTCCT-1	Monocytes
CGAATGTTCTGAAAGA-1	T cells
AGTGTCACAGCTGCTG-1	Monocytes
TATCTCACATTTGCCC-1	Monocytes
TCACGAACAGGTCGTC-1	T cells
CTAACTTTCAGCTTAG-1	Doublets
TTTATGCAGCCACGCT-1	Monocytes
CTGATAGTCGAATGGG-1	T cells
ATCACGAGTCTGGTCG-1	B cells
CAGCGACCACCGTTGG-1	T cells
GGCGACTCAGGAATGC-1	T cells
TAGTGGTGTTACCGAT-1	T cells
GCGCCAAGTTCAGCGC-1	T cells
AAGCCGCTCATACGGT-1	Monocytes
GAAATGAGTAGCGTAG-1	B cells
AGTAGTCTCAGGCCCA-1	T cells
AGAGCGAAGTGTTAGA-1	T cells
GCTCCTAAGAGAACAG-1	T cells
GTTCGGGAGGGTCTCC-1	Doublets
ACGTCAAGTTCAGCGC-1	T cells
GTCGGGTCAAGCGATG-1	T cells
AGGCCACAGCTTATCG-1	T cells
ATAGACCTCTCGATGA-1	Monocytes
AGTGTCACAGACGTAG-1	Monocytes
CTACGTCCAGCCTTTC-1	T cells
AACTCCCAGAAACCTA-1	T cells
GATCGCGGTCTGATTG-1	T cells
CGTCCATTCGCCAGCA-1	T cells
CTCAGAAAGAGTAATC-1	B cells
CTGAAGTGTTAAGAAC-1	Doublets
GGATGTTGTCTGCCAG-1	Monocytes
AGACGTTAGACCACGA-1	Monocytes
CGATGTAAGCGTTCCG-1	B cells
GGATTACAGATCCGAG-1	NK cells
CTGTGCTCAAAGCAAT-1	B cells
CTCTAATTCCAAACTG-1	T cells
GCAGCCAGTCGGCACT-1	T cells
AGTAGTCAGGTACTCT-1	Monocytes
TACTTACAGGTTACCT-1	T cells
CACAAACAGACTGGGT-1	Monocytes
GTGCAGCAGCGTCTAT-1	Monocytes
CGACCTTTCGGAAACG-1	mDCs
GCAGTTAGTGGCCCTA-1	T cells
GCGCGATCATAGGATA-1	T cells
